timestamp,stage,model,prompt_tokens,completion_tokens,total_tokens
2025-08-10T10:45:32Z,RUN_TOTAL,,0,0,0
2025-08-10T10:46:39Z,RUN_TOTAL,,0,0,0
2025-08-10T10:49:15Z,RUN_TOTAL,,0,0,0
2025-08-10T12:50:51Z,sentiment,gpt-4.1-mini,1656,123,1779
2025-08-10T12:50:53Z,sentiment,gpt-4.1-mini,1460,99,1559
2025-08-10T12:50:55Z,sentiment,gpt-4.1-mini,1194,105,1299
2025-08-10T12:50:56Z,sentiment,gpt-4.1-mini,885,89,974
2025-08-10T12:51:00Z,sentiment,gpt-4.1-mini,2332,219,2551
2025-08-10T12:51:02Z,sentiment,gpt-4.1-mini,1725,97,1822
2025-08-10T12:51:04Z,sentiment,gpt-4.1-mini,810,92,902
2025-08-10T12:51:07Z,sentiment,gpt-4.1-mini,2795,166,2961
2025-08-10T12:51:09Z,sentiment,gpt-4.1-mini,1855,183,2038
2025-08-10T12:51:13Z,sentiment,gpt-4.1-mini,2110,94,2204
2025-08-10T12:51:15Z,sentiment,gpt-4.1-mini,1881,99,1980
2025-08-10T12:51:18Z,sentiment,gpt-4.1-mini,1852,177,2029
2025-08-10T12:51:19Z,sentiment,gpt-4.1-mini,1675,86,1761
2025-08-10T12:51:21Z,sentiment,gpt-4.1-mini,1533,120,1653
2025-08-10T12:51:24Z,sentiment,gpt-4.1-mini,1551,97,1648
2025-08-10T12:51:25Z,sentiment,gpt-4.1-mini,1681,101,1782
2025-08-10T12:51:27Z,sentiment,gpt-4.1-mini,1053,113,1166
2025-08-10T12:51:30Z,sentiment,gpt-4.1-mini,1200,175,1375
2025-08-10T12:51:58Z,final_summary_en,gpt-4.1-mini,1144,871,2015
2025-08-10T12:52:28Z,final_summary_en,gpt-4.1-mini,2734,1006,3740
2025-08-10T12:53:03Z,final_summary_en,gpt-4.1-mini,1801,1301,3102
2025-08-10T12:53:23Z,final_summary_en,gpt-4.1-mini,2315,1209,3524
2025-08-10T12:53:53Z,final_summary_en,gpt-4.1-mini,1814,1199,3013
2025-08-10T10:53:54Z,RUN_TOTAL,,39056,7821,46877
2025-08-10T13:07:08Z,sentiment,gpt-4.1-mini,1656,116,1772
2025-08-10T13:07:10Z,sentiment,gpt-4.1-mini,1481,93,1574
2025-08-10T13:07:11Z,sentiment,gpt-4.1-mini,1194,100,1294
2025-08-10T13:07:13Z,sentiment,gpt-4.1-mini,885,88,973
2025-08-10T13:07:16Z,sentiment,gpt-4.1-mini,2332,194,2526
2025-08-10T13:07:18Z,sentiment,gpt-4.1-mini,1725,93,1818
2025-08-10T13:07:20Z,sentiment,gpt-4.1-mini,810,93,903
2025-08-10T13:07:22Z,sentiment,gpt-4.1-mini,2795,127,2922
2025-08-10T13:07:25Z,sentiment,gpt-4.1-mini,1855,171,2026
2025-08-10T13:07:26Z,sentiment,gpt-4.1-mini,2110,101,2211
2025-08-10T13:07:28Z,sentiment,gpt-4.1-mini,1881,99,1980
2025-08-10T13:07:31Z,sentiment,gpt-4.1-mini,1852,177,2029
2025-08-10T13:07:32Z,sentiment,gpt-4.1-mini,1675,96,1771
2025-08-10T13:07:34Z,sentiment,gpt-4.1-mini,1551,108,1659
2025-08-10T13:07:36Z,sentiment,gpt-4.1-mini,1681,107,1788
2025-08-10T13:07:37Z,sentiment,gpt-4.1-mini,1173,89,1262
2025-08-10T13:07:41Z,sentiment,gpt-4.1-mini,1053,95,1148
2025-08-10T13:07:44Z,sentiment,gpt-4.1-mini,1200,167,1367
2025-08-10T13:08:30Z,sentiment,gpt-4.1-mini,1076,170,1246
2025-08-10T13:08:32Z,sentiment,gpt-4.1-mini,747,76,823
2025-08-10T13:08:35Z,sentiment,gpt-4.1-mini,2282,159,2441
2025-08-10T13:08:36Z,sentiment,gpt-4.1-mini,1413,94,1507
2025-08-10T13:08:40Z,sentiment,gpt-4.1-mini,2446,195,2641
2025-08-10T13:08:45Z,sentiment,gpt-4.1-mini,1545,359,1904
2025-08-10T13:08:47Z,sentiment,gpt-4.1-mini,749,93,842
2025-08-10T13:08:49Z,sentiment,gpt-4.1-mini,1597,101,1698
2025-08-10T13:08:50Z,sentiment,gpt-4.1-mini,2646,104,2750
2025-08-10T13:08:54Z,sentiment,gpt-4.1-mini,1486,188,1674
2025-08-10T13:08:56Z,sentiment,gpt-4.1-mini,1276,181,1457
2025-08-10T13:09:00Z,sentiment,gpt-4.1-mini,1287,192,1479
2025-08-10T13:09:03Z,sentiment,gpt-4.1-mini,1240,192,1432
2025-08-10T13:09:07Z,sentiment,gpt-4.1-mini,1830,210,2040
2025-08-10T13:09:09Z,sentiment,gpt-4.1-mini,1639,163,1802
2025-08-10T13:09:11Z,sentiment,gpt-4.1-mini,776,91,867
2025-08-10T13:09:14Z,sentiment,gpt-4.1-mini,1017,184,1201
2025-08-10T13:09:16Z,sentiment,gpt-4.1-mini,866,90,956
2025-08-10T13:09:18Z,sentiment,gpt-4.1-mini,830,99,929
2025-08-10T13:09:20Z,sentiment,gpt-4.1-mini,884,86,970
2025-08-10T13:10:00Z,sentiment,gpt-4.1-mini,1778,202,1980
2025-08-10T13:10:32Z,sentiment,gpt-4.1-mini,1649,152,1801
2025-08-10T13:10:35Z,sentiment,gpt-4.1-mini,1210,136,1346
2025-08-10T13:10:57Z,sentiment,gpt-4.1-mini,1210,124,1334
2025-08-10T13:11:32Z,sentiment,gpt-4.1-mini,1892,191,2083
2025-08-10T13:11:38Z,sentiment,gpt-4.1-mini,1988,100,2088
2025-08-10T13:11:41Z,sentiment,gpt-4.1-mini,2030,191,2221
2025-08-10T13:11:44Z,sentiment,gpt-4.1-mini,1633,169,1802
2025-08-10T13:12:27Z,final_summary_en,gpt-4.1-mini,1981,1150,3131
2025-08-10T13:12:51Z,final_summary_en,gpt-4.1-mini,1148,907,2055
2025-08-10T13:13:06Z,final_summary_en,gpt-4.1-mini,2387,1071,3458
2025-08-10T13:13:43Z,final_summary_en,gpt-4.1-mini,1839,1209,3048
2025-08-10T13:14:03Z,final_summary_en,gpt-4.1-mini,2216,1381,3597
2025-08-10T13:14:26Z,final_summary_en,gpt-4.1-mini,1439,1002,2441
2025-08-10T13:14:59Z,final_summary_en,gpt-4.1-mini,1228,1117,2345
2025-08-10T13:15:27Z,final_summary_en,gpt-4.1-mini,1805,1135,2940
2025-08-10T13:15:53Z,final_summary_en,gpt-4.1-mini,1186,1090,2276
2025-08-10T13:16:23Z,final_summary_en,gpt-4.1-mini,2291,1252,3543
2025-08-10T13:16:48Z,final_summary_en,gpt-4.1-mini,1794,945,2739
2025-08-10T13:17:09Z,final_summary_en,gpt-4.1-mini,1577,1094,2671
2025-08-10T13:17:32Z,final_summary_en,gpt-4.1-mini,957,1003,1960
2025-08-10T13:18:03Z,final_summary_en,gpt-4.1-mini,1252,1435,2687
2025-08-10T13:18:32Z,final_summary_en,gpt-4.1-mini,1737,1151,2888
2025-08-10T13:18:53Z,final_summary_en,gpt-4.1-mini,1581,1104,2685
2025-08-10T13:19:09Z,final_summary_en,gpt-4.1-mini,1017,900,1917
2025-08-10T13:19:25Z,final_summary_en,gpt-4.1-mini,1571,1143,2714
2025-08-10T13:20:31Z,category_summary,gpt-4.1-mini,130,36,166
2025-08-10T13:20:33Z,category_summary,gpt-4.1-mini,135,33,168
2025-08-10T13:20:34Z,category_summary,gpt-4.1-mini,115,34,149
2025-08-10T13:20:37Z,category_summary,gpt-4.1-mini,134,38,172
2025-08-10T13:20:38Z,category_summary,gpt-4.1-mini,104,33,137
2025-08-10T13:20:40Z,category_summary,gpt-4.1-mini,104,28,132
2025-08-10T11:20:40Z,RUN_TOTAL,,99659,26697,126356
2025-08-10T15:28:38Z,sentiment,gpt-4.1-mini,1839,136,1975
2025-08-10T15:28:41Z,sentiment,gpt-4.1-mini,1381,112,1493
2025-08-10T15:28:43Z,sentiment,gpt-4.1-mini,1068,99,1167
2025-08-10T15:28:44Z,sentiment,gpt-4.1-mini,1589,89,1678
2025-08-10T15:28:47Z,sentiment,gpt-4.1-mini,2035,109,2144
2025-08-10T15:28:49Z,sentiment,gpt-4.1-mini,2516,115,2631
2025-08-10T15:28:59Z,sentiment,gpt-4.1-mini,3859,469,4328
2025-08-10T15:29:01Z,sentiment,gpt-4.1-mini,2039,97,2136
2025-08-10T15:29:04Z,sentiment,gpt-4.1-mini,2294,103,2397
2025-08-10T15:29:07Z,sentiment,gpt-4.1-mini,2067,99,2166
2025-08-10T15:29:14Z,sentiment,gpt-4.1-mini,2035,425,2460
2025-08-10T15:29:22Z,sentiment,gpt-4.1-mini,1156,331,1487
2025-08-10T15:29:24Z,sentiment,gpt-4.1-mini,1734,94,1828
2025-08-10T15:29:26Z,sentiment,gpt-4.1-mini,1864,99,1963
2025-08-10T15:29:28Z,sentiment,gpt-4.1-mini,1496,111,1607
2025-08-10T15:30:11Z,sentiment,gpt-4.1-mini,1259,386,1645
2025-08-10T15:30:13Z,sentiment,gpt-4.1-mini,930,86,1016
2025-08-10T15:30:22Z,sentiment,gpt-4.1-mini,2465,545,3010
2025-08-10T15:30:25Z,sentiment,gpt-4.1-mini,1596,95,1691
2025-08-10T15:30:33Z,sentiment,gpt-4.1-mini,2992,516,3508
2025-08-10T15:30:39Z,sentiment,gpt-4.1-mini,1728,391,2119
2025-08-10T15:30:41Z,sentiment,gpt-4.1-mini,932,89,1021
2025-08-10T15:30:43Z,sentiment,gpt-4.1-mini,1780,112,1892
2025-08-10T15:30:45Z,sentiment,gpt-4.1-mini,3562,110,3672
2025-08-10T15:30:52Z,sentiment,gpt-4.1-mini,1669,423,2092
2025-08-10T15:31:00Z,sentiment,gpt-4.1-mini,1459,436,1895
2025-08-10T15:31:06Z,sentiment,gpt-4.1-mini,1470,392,1862
2025-08-10T15:31:12Z,sentiment,gpt-4.1-mini,1423,375,1798
2025-08-10T15:31:20Z,sentiment,gpt-4.1-mini,2013,438,2451
2025-08-10T15:31:28Z,sentiment,gpt-4.1-mini,1823,478,2301
2025-08-10T15:31:56Z,sentiment,gpt-4.1-mini,1828,533,2361
2025-08-10T15:32:09Z,sentiment,gpt-4.1-mini,1795,93,1888
2025-08-10T15:32:17Z,sentiment,gpt-4.1-mini,1961,470,2431
2025-08-10T15:32:42Z,sentiment,gpt-4.1-mini,1832,485,2317
2025-08-10T15:32:44Z,sentiment,gpt-4.1-mini,1393,85,1478
2025-08-10T15:32:54Z,sentiment,gpt-4.1-mini,1393,92,1485
2025-08-10T15:33:32Z,sentiment,gpt-4.1-mini,2075,525,2600
2025-08-10T15:33:44Z,sentiment,gpt-4.1-mini,2615,537,3152
2025-08-10T15:33:46Z,sentiment,gpt-4.1-mini,2171,105,2276
2025-08-10T15:33:54Z,sentiment,gpt-4.1-mini,2213,486,2699
2025-08-10T15:34:05Z,sentiment,gpt-4.1-mini,1816,441,2257
2025-08-10T15:34:16Z,article_selection,gpt-4.1-mini,716,12,728
2025-08-10T15:34:16Z,article_selection,gpt-4.1-mini,773,9,782
2025-08-10T15:34:17Z,article_selection,gpt-4.1-mini,583,9,592
2025-08-10T15:34:18Z,article_selection,gpt-4.1-mini,729,12,741
2025-08-10T15:34:18Z,article_selection,gpt-4.1-mini,513,13,526
2025-08-10T15:34:32Z,final_summary_en,gpt-4.1-mini,868,1010,1878
2025-08-10T15:34:54Z,final_summary_en,gpt-4.1-mini,920,1166,2086
2025-08-10T15:35:12Z,final_summary_en,gpt-4.1-mini,968,1288,2256
2025-08-10T15:35:30Z,final_summary_en,gpt-4.1-mini,828,1211,2039
2025-08-10T15:35:58Z,final_summary_en,gpt-4.1-mini,896,970,1866
2025-08-10T15:36:27Z,final_summary_en,gpt-4.1-mini,993,1172,2165
2025-08-10T15:36:56Z,final_summary_en,gpt-4.1-mini,929,1184,2113
2025-08-10T15:37:27Z,final_summary_en,gpt-4.1-mini,898,1028,1926
2025-08-10T15:37:57Z,final_summary_en,gpt-4.1-mini,814,1105,1919
2025-08-10T15:38:31Z,final_summary_en,gpt-4.1-mini,765,1006,1771
2025-08-10T15:38:59Z,final_summary_en,gpt-4.1-mini,983,1192,2175
2025-08-10T15:39:15Z,final_summary_en,gpt-4.1-mini,861,1215,2076
2025-08-10T15:39:52Z,final_summary_en,gpt-4.1-mini,949,1327,2276
2025-08-10T15:40:09Z,final_summary_en,gpt-4.1-mini,933,1215,2148
2025-08-10T15:40:40Z,final_summary_en,gpt-4.1-mini,861,1385,2246
2025-08-10T15:41:05Z,final_summary_en,gpt-4.1-mini,808,1131,1939
2025-08-10T15:41:35Z,final_summary_en,gpt-4.1-mini,902,1164,2066
2025-08-10T15:41:55Z,final_summary_en,gpt-4.1-mini,822,1077,1899
2025-08-10T15:41:57Z,category_summary,gpt-4.1-mini,130,35,165
2025-08-10T15:41:59Z,category_summary,gpt-4.1-mini,145,33,178
2025-08-10T15:42:00Z,category_summary,gpt-4.1-mini,120,32,152
2025-08-10T15:42:02Z,category_summary,gpt-4.1-mini,139,36,175
2025-08-10T15:42:04Z,category_summary,gpt-4.1-mini,116,39,155
2025-08-10T13:42:04Z,RUN_TOTAL,,97127,32288,129415
2025-08-11T04:48:08Z,sentiment,gpt-4.1-mini,1156,102,1258
2025-08-11T04:48:10Z,sentiment,gpt-4.1-mini,4107,93,4200
2025-08-11T04:48:14Z,sentiment,gpt-4.1-mini,1556,84,1640
2025-08-11T04:48:17Z,sentiment,gpt-4.1-mini,2019,165,2184
2025-08-11T04:48:19Z,sentiment,gpt-4.1-mini,1001,166,1167
2025-08-11T04:48:20Z,sentiment,gpt-4.1-mini,1034,87,1121
2025-08-11T04:48:22Z,sentiment,gpt-4.1-mini,1125,88,1213
2025-08-11T04:48:26Z,sentiment,gpt-4.1-mini,1352,91,1443
2025-08-11T04:48:29Z,sentiment,gpt-4.1-mini,1068,180,1248
2025-08-11T04:48:30Z,sentiment,gpt-4.1-mini,1167,86,1253
2025-08-11T04:48:32Z,sentiment,gpt-4.1-mini,1264,100,1364
2025-08-11T04:48:34Z,sentiment,gpt-4.1-mini,1024,118,1142
2025-08-11T04:48:36Z,sentiment,gpt-4.1-mini,1884,98,1982
2025-08-11T04:48:42Z,sentiment,gpt-4.1-mini,1352,93,1445
2025-08-11T04:48:49Z,sentiment,gpt-4.1-mini,1361,132,1493
2025-08-11T04:48:51Z,sentiment,gpt-4.1-mini,972,119,1091
2025-08-11T04:48:59Z,sentiment,gpt-4.1-mini,1374,159,1533
2025-08-11T04:49:02Z,sentiment,gpt-4.1-mini,1777,170,1947
2025-08-11T04:49:05Z,sentiment,gpt-4.1-mini,2133,182,2315
2025-08-11T04:49:08Z,sentiment,gpt-4.1-mini,2787,208,2995
2025-08-11T04:49:10Z,sentiment,gpt-4.1-mini,1722,127,1849
2025-08-11T04:49:14Z,sentiment,gpt-4.1-mini,2356,186,2542
2025-08-11T04:49:29Z,sentiment,gpt-4.1-mini,746,85,831
2025-08-11T04:49:31Z,sentiment,gpt-4.1-mini,1412,104,1516
2025-08-11T04:49:32Z,sentiment,gpt-4.1-mini,1544,122,1666
2025-08-11T04:49:34Z,sentiment,gpt-4.1-mini,748,76,824
2025-08-11T04:49:36Z,sentiment,gpt-4.1-mini,1596,101,1697
2025-08-11T04:49:38Z,sentiment,gpt-4.1-mini,3378,99,3477
2025-08-11T04:50:19Z,sentiment,gpt-4.1-mini,1611,85,1696
2025-08-11T04:50:24Z,sentiment,gpt-4.1-mini,3422,102,3524
2025-08-11T04:50:26Z,sentiment,gpt-4.1-mini,1497,122,1619
2025-08-11T04:50:58Z,sentiment,gpt-4.1-mini,1642,159,1801
2025-08-11T04:51:01Z,sentiment,gpt-4.1-mini,1999,177,2176
2025-08-11T04:51:18Z,sentiment,gpt-4.1-mini,1279,88,1367
2025-08-11T04:51:19Z,sentiment,gpt-4.1-mini,1536,88,1624
2025-08-11T04:51:22Z,sentiment,gpt-4.1-mini,1108,177,1285
2025-08-11T04:51:23Z,sentiment,gpt-4.1-mini,840,81,921
2025-08-11T04:51:36Z,sentiment,gpt-4.1-mini,1408,155,1563
2025-08-11T04:51:40Z,sentiment,gpt-4.1-mini,2431,198,2629
2025-08-11T04:51:41Z,sentiment,gpt-4.1-mini,1987,97,2084
2025-08-11T04:51:59Z,article_selection,gpt-4.1-mini,894,12,906
2025-08-11T04:51:59Z,article_selection,gpt-4.1-mini,598,9,607
2025-08-11T04:51:59Z,article_selection,gpt-4.1-mini,750,9,759
2025-08-11T04:52:00Z,article_selection,gpt-4.1-mini,411,5,416
2025-08-11T04:52:19Z,final_summary_en,gpt-4.1-mini,2301,1045,3346
2025-08-11T04:52:35Z,final_summary_en,gpt-4.1-mini,1939,1039,2978
2025-08-11T04:52:52Z,final_summary_en,gpt-4.1-mini,2074,1421,3495
2025-08-11T04:53:09Z,final_summary_en,gpt-4.1-mini,2733,1263,3996
2025-08-11T04:53:23Z,final_summary_en,gpt-4.1-mini,885,875,1760
2025-08-11T04:53:39Z,final_summary_en,gpt-4.1-mini,1311,1251,2562
2025-08-11T04:53:54Z,final_summary_en,gpt-4.1-mini,1706,1248,2954
2025-08-11T04:54:19Z,final_summary_en,gpt-4.1-mini,1562,1239,2801
2025-08-11T04:54:32Z,final_summary_en,gpt-4.1-mini,1064,1070,2134
2025-08-11T04:54:48Z,final_summary_en,gpt-4.1-mini,2375,1269,3644
2025-08-11T04:55:02Z,final_summary_en,gpt-4.1-mini,1956,1159,3115
2025-08-11T04:55:18Z,final_summary_en,gpt-4.1-mini,1343,1315,2658
2025-08-11T04:55:30Z,final_summary_en,gpt-4.1-mini,1027,1004,2031
2025-08-11T04:55:42Z,final_summary_en,gpt-4.1-mini,1465,942,2407
2025-08-11T04:55:43Z,category_summary,gpt-4.1-mini,142,39,181
2025-08-11T04:55:45Z,category_summary,gpt-4.1-mini,139,34,173
2025-08-11T04:55:46Z,category_summary,gpt-4.1-mini,77,16,93
2025-08-11T04:55:48Z,category_summary,gpt-4.1-mini,101,36,137
2025-08-11T04:55:49Z,category_summary,gpt-4.1-mini,114,39,153
2025-08-11T04:55:50Z,RUN_TOTAL,,92742,21289,114031
2025-08-11T08:51:20Z,sentiment,gpt-4.1-mini,4107,92,4199
2025-08-11T08:51:22Z,sentiment,gpt-4.1-mini,1282,96,1378
2025-08-11T08:51:26Z,sentiment,gpt-4.1-mini,2019,201,2220
2025-08-11T08:51:28Z,sentiment,gpt-4.1-mini,3412,95,3507
2025-08-11T08:51:34Z,sentiment,gpt-4.1-mini,1003,157,1160
2025-08-11T08:51:37Z,sentiment,gpt-4.1-mini,867,83,950
2025-08-11T08:51:39Z,sentiment,gpt-4.1-mini,1144,81,1225
2025-08-11T08:51:41Z,sentiment,gpt-4.1-mini,1269,103,1372
2025-08-11T08:51:44Z,sentiment,gpt-4.1-mini,1352,97,1449
2025-08-11T08:51:47Z,sentiment,gpt-4.1-mini,1024,117,1141
2025-08-11T08:51:51Z,sentiment,gpt-4.1-mini,2439,168,2607
2025-08-11T08:51:54Z,sentiment,gpt-4.1-mini,2211,158,2369
2025-08-11T08:51:56Z,sentiment,gpt-4.1-mini,1884,97,1981
2025-08-11T08:51:58Z,sentiment,gpt-4.1-mini,1034,83,1117
2025-08-11T08:52:05Z,sentiment,gpt-4.1-mini,1352,107,1459
2025-08-11T08:52:14Z,sentiment,gpt-4.1-mini,1361,123,1484
2025-08-11T08:52:17Z,sentiment,gpt-4.1-mini,972,111,1083
2025-08-11T08:52:34Z,sentiment,gpt-4.1-mini,1547,196,1743
2025-08-11T08:52:38Z,sentiment,gpt-4.1-mini,1606,174,1780
2025-08-11T08:52:41Z,sentiment,gpt-4.1-mini,1374,184,1558
2025-08-11T08:52:44Z,sentiment,gpt-4.1-mini,1777,172,1949
2025-08-11T08:52:48Z,sentiment,gpt-4.1-mini,2133,185,2318
2025-08-11T08:52:50Z,sentiment,gpt-4.1-mini,2787,185,2972
2025-08-11T08:52:53Z,sentiment,gpt-4.1-mini,1722,111,1833
2025-08-11T08:52:57Z,sentiment,gpt-4.1-mini,2356,190,2546
2025-08-11T08:53:09Z,sentiment,gpt-4.1-mini,746,78,824
2025-08-11T08:53:12Z,sentiment,gpt-4.1-mini,1412,89,1501
2025-08-11T08:53:14Z,sentiment,gpt-4.1-mini,1544,132,1676
2025-08-11T08:53:16Z,sentiment,gpt-4.1-mini,748,83,831
2025-08-11T08:53:18Z,sentiment,gpt-4.1-mini,1596,116,1712
2025-08-11T08:53:20Z,sentiment,gpt-4.1-mini,3378,98,3476
2025-08-11T08:54:00Z,sentiment,gpt-4.1-mini,1611,86,1697
2025-08-11T08:54:06Z,sentiment,gpt-4.1-mini,3422,106,3528
2025-08-11T08:54:08Z,sentiment,gpt-4.1-mini,1497,114,1611
2025-08-11T08:54:49Z,sentiment,gpt-4.1-mini,1642,174,1816
2025-08-11T08:54:53Z,sentiment,gpt-4.1-mini,1999,201,2200
2025-08-11T08:55:12Z,sentiment,gpt-4.1-mini,1279,128,1407
2025-08-11T08:55:15Z,sentiment,gpt-4.1-mini,1536,133,1669
2025-08-11T08:55:19Z,sentiment,gpt-4.1-mini,1108,182,1290
2025-08-11T08:55:21Z,sentiment,gpt-4.1-mini,840,91,931
2025-08-11T08:55:50Z,article_selection,gpt-4.1-mini,897,9,906
2025-08-11T08:55:51Z,article_selection,gpt-4.1-mini,378,3,381
2025-08-11T08:55:52Z,article_selection,gpt-4.1-mini,517,7,524
2025-08-11T08:55:52Z,article_selection,gpt-4.1-mini,598,9,607
2025-08-11T08:55:53Z,article_selection,gpt-4.1-mini,655,9,664
2025-08-11T08:56:13Z,final_summary_en,gpt-4.1-mini,932,972,1904
2025-08-11T08:56:36Z,final_summary_en,gpt-4.1-mini,2296,1130,3426
2025-08-11T08:57:01Z,final_summary_en,gpt-4.1-mini,1936,1041,2977
2025-08-11T08:57:27Z,final_summary_en,gpt-4.1-mini,2088,1295,3383
2025-08-11T08:57:53Z,final_summary_en,gpt-4.1-mini,2133,1001,3134
2025-08-11T08:58:19Z,final_summary_en,gpt-4.1-mini,1496,1035,2531
2025-08-11T08:58:43Z,final_summary_en,gpt-4.1-mini,1546,901,2447
2025-08-11T08:59:07Z,final_summary_en,gpt-4.1-mini,1460,828,2288
2025-08-11T08:59:40Z,final_summary_en,gpt-4.1-mini,1318,1339,2657
2025-08-11T09:00:11Z,final_summary_en,gpt-4.1-mini,1708,1374,3082
2025-08-11T09:00:35Z,final_summary_en,gpt-4.1-mini,882,920,1802
2025-08-11T09:01:16Z,final_summary_en,gpt-4.1-mini,1578,1105,2683
2025-08-11T09:01:40Z,final_summary_en,gpt-4.1-mini,1051,933,1984
2025-08-11T09:02:22Z,final_summary_en,gpt-4.1-mini,1978,1324,3302
2025-08-11T09:02:49Z,final_summary_en,gpt-4.1-mini,942,1104,2046
2025-08-11T09:03:51Z,category_summary,gpt-4.1-mini,141,39,180
2025-08-11T09:03:53Z,category_summary,gpt-4.1-mini,128,24,152
2025-08-11T09:03:55Z,category_summary,gpt-4.1-mini,99,23,122
2025-08-11T09:03:56Z,category_summary,gpt-4.1-mini,90,24,114
2025-08-11T09:03:58Z,category_summary,gpt-4.1-mini,114,26,140
2025-08-11T07:03:58Z,RUN_TOTAL,,95353,21652,117005
2025-08-12T04:30:41Z,sentiment,gpt-4.1-mini,1094,87,1181
2025-08-12T04:30:43Z,sentiment,gpt-4.1-mini,1461,87,1548
2025-08-12T04:30:45Z,sentiment,gpt-4.1-mini,2686,105,2791
2025-08-12T04:30:47Z,sentiment,gpt-4.1-mini,1478,91,1569
2025-08-12T04:30:50Z,sentiment,gpt-4.1-mini,1573,91,1664
2025-08-12T04:30:52Z,sentiment,gpt-4.1-mini,799,96,895
2025-08-12T04:30:54Z,sentiment,gpt-4.1-mini,1430,159,1589
2025-08-12T04:30:56Z,sentiment,gpt-4.1-mini,1482,103,1585
2025-08-12T04:30:57Z,sentiment,gpt-4.1-mini,1018,85,1103
2025-08-12T04:30:59Z,sentiment,gpt-4.1-mini,1689,85,1774
2025-08-12T04:31:00Z,sentiment,gpt-4.1-mini,1287,82,1369
2025-08-12T04:31:02Z,sentiment,gpt-4.1-mini,2039,83,2122
2025-08-12T04:31:04Z,sentiment,gpt-4.1-mini,1894,144,2038
2025-08-12T04:31:06Z,sentiment,gpt-4.1-mini,1618,106,1724
2025-08-12T04:31:13Z,sentiment,gpt-4.1-mini,1478,91,1569
2025-08-12T04:31:14Z,sentiment,gpt-4.1-mini,794,88,882
2025-08-12T04:31:16Z,sentiment,gpt-4.1-mini,1022,82,1104
2025-08-12T04:31:19Z,sentiment,gpt-4.1-mini,1601,156,1757
2025-08-12T04:31:21Z,sentiment,gpt-4.1-mini,904,119,1023
2025-08-12T04:31:23Z,sentiment,gpt-4.1-mini,1470,95,1565
2025-08-12T04:31:30Z,sentiment,gpt-4.1-mini,1018,85,1103
2025-08-12T04:31:33Z,sentiment,gpt-4.1-mini,2741,166,2907
2025-08-12T04:31:35Z,sentiment,gpt-4.1-mini,1617,111,1728
2025-08-12T04:31:44Z,sentiment,gpt-4.1-mini,1370,166,1536
2025-08-12T04:31:47Z,sentiment,gpt-4.1-mini,1144,153,1297
2025-08-12T04:31:49Z,sentiment,gpt-4.1-mini,1855,133,1988
2025-08-12T04:31:52Z,sentiment,gpt-4.1-mini,1641,194,1835
2025-08-12T04:31:56Z,sentiment,gpt-4.1-mini,1549,185,1734
2025-08-12T04:31:59Z,sentiment,gpt-4.1-mini,1681,175,1856
2025-08-12T04:32:02Z,sentiment,gpt-4.1-mini,1859,166,2025
2025-08-12T04:32:20Z,sentiment,gpt-4.1-mini,950,82,1032
2025-08-12T04:32:23Z,sentiment,gpt-4.1-mini,993,174,1167
2025-08-12T04:32:25Z,sentiment,gpt-4.1-mini,914,82,996
2025-08-12T04:32:26Z,sentiment,gpt-4.1-mini,949,119,1068
2025-08-12T04:32:29Z,sentiment,gpt-4.1-mini,3641,175,3816
2025-08-12T04:32:30Z,sentiment,gpt-4.1-mini,2060,99,2159
2025-08-12T04:32:32Z,sentiment,gpt-4.1-mini,750,81,831
2025-08-12T04:32:33Z,sentiment,gpt-4.1-mini,1416,108,1524
2025-08-12T04:32:36Z,sentiment,gpt-4.1-mini,1547,178,1725
2025-08-12T04:32:37Z,sentiment,gpt-4.1-mini,752,82,834
2025-08-12T04:32:39Z,sentiment,gpt-4.1-mini,1600,104,1704
2025-08-12T04:32:58Z,sentiment,gpt-4.1-mini,1167,96,1263
2025-08-12T04:33:00Z,sentiment,gpt-4.1-mini,1067,156,1223
2025-08-12T04:33:03Z,sentiment,gpt-4.1-mini,1867,174,2041
2025-08-12T04:33:06Z,sentiment,gpt-4.1-mini,1512,193,1705
2025-08-12T04:33:08Z,sentiment,gpt-4.1-mini,1420,143,1563
2025-08-12T04:33:11Z,sentiment,gpt-4.1-mini,986,145,1131
2025-08-12T04:33:14Z,sentiment,gpt-4.1-mini,1199,155,1354
2025-08-12T04:33:21Z,sentiment,gpt-4.1-mini,1103,160,1263
2025-08-12T04:33:24Z,sentiment,gpt-4.1-mini,3334,93,3427
2025-08-12T04:33:30Z,sentiment,gpt-4.1-mini,2792,182,2974
2025-08-12T04:33:33Z,sentiment,gpt-4.1-mini,1713,143,1856
2025-08-12T04:33:38Z,sentiment,gpt-4.1-mini,2615,97,2712
2025-08-12T04:33:41Z,sentiment,gpt-4.1-mini,4166,119,4285
2025-08-12T04:33:43Z,sentiment,gpt-4.1-mini,1807,92,1899
2025-08-12T04:33:44Z,sentiment,gpt-4.1-mini,3407,103,3510
2025-08-12T04:34:09Z,sentiment,gpt-4.1-mini,1595,175,1770
2025-08-12T04:34:11Z,sentiment,gpt-4.1-mini,1238,144,1382
2025-08-12T04:34:14Z,sentiment,gpt-4.1-mini,1275,159,1434
2025-08-12T04:34:16Z,sentiment,gpt-4.1-mini,1462,172,1634
2025-08-12T04:34:19Z,sentiment,gpt-4.1-mini,3773,183,3956
2025-08-12T04:34:20Z,sentiment,gpt-4.1-mini,1281,89,1370
2025-08-12T04:34:23Z,sentiment,gpt-4.1-mini,1532,164,1696
2025-08-12T04:34:40Z,sentiment,gpt-4.1-mini,1856,87,1943
2025-08-12T04:34:42Z,sentiment,gpt-4.1-mini,1249,87,1336
2025-08-12T04:35:09Z,sentiment,gpt-4.1-mini,1856,86,1942
2025-08-12T04:35:12Z,sentiment,gpt-4.1-mini,1249,113,1362
2025-08-12T04:35:57Z,sentiment,gpt-4.1-mini,1305,110,1415
2025-08-12T04:35:58Z,sentiment,gpt-4.1-mini,1305,94,1399
2025-08-12T04:36:14Z,sentiment,gpt-4.1-mini,1467,169,1636
2025-08-12T04:36:16Z,sentiment,gpt-4.1-mini,1305,89,1394
2025-08-12T04:36:18Z,sentiment,gpt-4.1-mini,1759,180,1939
2025-08-12T04:36:20Z,sentiment,gpt-4.1-mini,1287,135,1422
2025-08-12T04:36:21Z,sentiment,gpt-4.1-mini,1693,86,1779
2025-08-12T04:36:23Z,sentiment,gpt-4.1-mini,1275,89,1364
2025-08-12T04:36:41Z,sentiment,gpt-4.1-mini,1825,159,1984
2025-08-12T04:36:43Z,sentiment,gpt-4.1-mini,1401,104,1505
2025-08-12T04:36:45Z,sentiment,gpt-4.1-mini,2339,118,2457
2025-08-12T04:36:47Z,sentiment,gpt-4.1-mini,1412,178,1590
2025-08-12T04:37:05Z,sentiment,gpt-4.1-mini,1049,112,1161
2025-08-12T04:37:07Z,sentiment,gpt-4.1-mini,1349,94,1443
2025-08-12T04:37:18Z,article_selection,gpt-4.1-mini,1046,9,1055
2025-08-12T04:37:18Z,article_selection,gpt-4.1-mini,841,16,857
2025-08-12T04:37:18Z,article_selection,gpt-4.1-mini,1261,12,1273
2025-08-12T04:37:19Z,article_selection,gpt-4.1-mini,1156,12,1168
2025-08-12T04:37:19Z,article_selection,gpt-4.1-mini,737,9,746
2025-08-12T04:37:20Z,article_selection,gpt-4.1-mini,388,1,389
2025-08-12T04:37:30Z,final_summary_en,gpt-4.1-mini,1519,1068,2587
2025-08-12T04:37:41Z,final_summary_en,gpt-4.1-mini,1596,1041,2637
2025-08-12T04:37:52Z,final_summary_en,gpt-4.1-mini,1493,1129,2622
2025-08-12T04:38:02Z,final_summary_en,gpt-4.1-mini,1787,982,2769
2025-08-12T04:38:15Z,final_summary_en,gpt-4.1-mini,3582,1216,4798
2025-08-12T04:38:26Z,final_summary_en,gpt-4.1-mini,1204,1015,2219
2025-08-12T04:38:37Z,final_summary_en,gpt-4.1-mini,1342,1181,2523
2025-08-12T04:38:53Z,final_summary_en,gpt-4.1-mini,2684,1156,3840
2025-08-12T04:39:08Z,final_summary_en,gpt-4.1-mini,1070,1301,2371
2025-08-12T04:39:26Z,final_summary_en,gpt-4.1-mini,1477,1459,2936
2025-08-12T04:39:39Z,final_summary_en,gpt-4.1-mini,1336,1025,2361
2025-08-12T04:39:54Z,final_summary_en,gpt-4.1-mini,1119,1030,2149
2025-08-12T04:40:07Z,final_summary_en,gpt-4.1-mini,870,1086,1956
2025-08-12T04:40:22Z,final_summary_en,gpt-4.1-mini,1483,1431,2914
2025-08-12T04:40:36Z,final_summary_en,gpt-4.1-mini,2734,1179,3913
2025-08-12T04:40:54Z,final_summary_en,gpt-4.1-mini,1525,1293,2818
2025-08-12T04:41:10Z,final_summary_en,gpt-4.1-mini,1401,1215,2616
2025-08-12T04:41:27Z,final_summary_en,gpt-4.1-mini,3703,1372,5075
2025-08-12T04:41:39Z,final_summary_en,gpt-4.1-mini,1171,1103,2274
2025-08-12T04:41:56Z,final_summary_en,gpt-4.1-mini,1298,1244,2542
2025-08-12T04:42:54Z,category_summary,gpt-4.1-mini,126,29,155
2025-08-12T04:42:57Z,category_summary,gpt-4.1-mini,135,27,162
2025-08-12T04:42:59Z,category_summary,gpt-4.1-mini,121,25,146
2025-08-12T04:43:01Z,category_summary,gpt-4.1-mini,131,37,168
2025-08-12T04:43:03Z,category_summary,gpt-4.1-mini,126,38,164
2025-08-12T04:43:05Z,RUN_TOTAL,,170618,33821,204439
2025-08-12T08:32:11Z,sentiment,gpt-4.1-mini,1233,147,1380
2025-08-12T08:32:14Z,sentiment,gpt-4.1-mini,2238,111,2349
2025-08-12T08:32:17Z,sentiment,gpt-4.1-mini,1653,153,1806
2025-08-12T08:32:19Z,sentiment,gpt-4.1-mini,2337,123,2460
2025-08-12T08:32:22Z,sentiment,gpt-4.1-mini,2834,177,3011
2025-08-12T08:32:25Z,sentiment,gpt-4.1-mini,1189,120,1309
2025-08-12T08:32:28Z,sentiment,gpt-4.1-mini,1918,144,2062
2025-08-12T08:32:30Z,sentiment,gpt-4.1-mini,1157,95,1252
2025-08-12T08:32:32Z,sentiment,gpt-4.1-mini,1712,152,1864
2025-08-12T08:32:34Z,sentiment,gpt-4.1-mini,1828,135,1963
2025-08-12T08:32:38Z,sentiment,gpt-4.1-mini,1403,179,1582
2025-08-12T08:32:41Z,sentiment,gpt-4.1-mini,2277,164,2441
2025-08-12T08:32:43Z,sentiment,gpt-4.1-mini,2033,153,2186
2025-08-12T08:32:46Z,sentiment,gpt-4.1-mini,2382,141,2523
2025-08-12T08:32:55Z,sentiment,gpt-4.1-mini,1918,132,2050
2025-08-12T08:32:57Z,sentiment,gpt-4.1-mini,933,125,1058
2025-08-12T08:32:59Z,sentiment,gpt-4.1-mini,1161,143,1304
2025-08-12T08:33:06Z,sentiment,gpt-4.1-mini,1740,239,1979
2025-08-12T08:33:08Z,sentiment,gpt-4.1-mini,1043,136,1179
2025-08-12T08:33:12Z,sentiment,gpt-4.1-mini,1168,153,1321
2025-08-12T08:33:15Z,sentiment,gpt-4.1-mini,1609,139,1748
2025-08-12T08:33:28Z,sentiment,gpt-4.1-mini,1157,101,1258
2025-08-12T08:33:32Z,sentiment,gpt-4.1-mini,2880,207,3087
2025-08-12T08:33:35Z,sentiment,gpt-4.1-mini,1764,157,1921
2025-08-12T08:33:51Z,sentiment,gpt-4.1-mini,1514,205,1719
2025-08-12T08:33:54Z,sentiment,gpt-4.1-mini,1613,204,1817
2025-08-12T08:33:58Z,sentiment,gpt-4.1-mini,1509,204,1713
2025-08-12T08:34:00Z,sentiment,gpt-4.1-mini,1283,143,1426
2025-08-12T08:34:04Z,sentiment,gpt-4.1-mini,1994,182,2176
2025-08-12T08:34:07Z,sentiment,gpt-4.1-mini,1780,206,1986
2025-08-12T08:34:10Z,sentiment,gpt-4.1-mini,1688,188,1876
2025-08-12T08:34:14Z,sentiment,gpt-4.1-mini,1820,210,2030
2025-08-12T08:34:18Z,sentiment,gpt-4.1-mini,1998,240,2238
2025-08-12T08:34:30Z,sentiment,gpt-4.1-mini,1089,127,1216
2025-08-12T08:34:33Z,sentiment,gpt-4.1-mini,1132,235,1367
2025-08-12T08:34:36Z,sentiment,gpt-4.1-mini,1053,135,1188
2025-08-12T08:34:39Z,sentiment,gpt-4.1-mini,1088,159,1247
2025-08-12T08:34:42Z,sentiment,gpt-4.1-mini,3780,212,3992
2025-08-12T08:34:45Z,sentiment,gpt-4.1-mini,2199,149,2348
2025-08-12T08:34:47Z,sentiment,gpt-4.1-mini,889,108,997
2025-08-12T08:34:49Z,sentiment,gpt-4.1-mini,1555,114,1669
2025-08-12T08:34:52Z,sentiment,gpt-4.1-mini,1686,204,1890
2025-08-12T08:34:54Z,sentiment,gpt-4.1-mini,891,93,984
2025-08-12T08:34:57Z,sentiment,gpt-4.1-mini,1739,167,1906
2025-08-12T08:35:18Z,sentiment,gpt-4.1-mini,1306,120,1426
2025-08-12T08:35:20Z,sentiment,gpt-4.1-mini,1206,135,1341
2025-08-12T08:35:23Z,sentiment,gpt-4.1-mini,2006,162,2168
2025-08-12T08:35:28Z,sentiment,gpt-4.1-mini,1651,215,1866
2025-08-12T08:35:32Z,sentiment,gpt-4.1-mini,1559,201,1760
2025-08-12T08:35:35Z,sentiment,gpt-4.1-mini,1125,169,1294
2025-08-12T08:35:38Z,sentiment,gpt-4.1-mini,1338,159,1497
2025-08-12T08:35:50Z,sentiment,gpt-4.1-mini,1242,214,1456
2025-08-12T08:35:53Z,sentiment,gpt-4.1-mini,3473,193,3666
2025-08-12T08:36:03Z,sentiment,gpt-4.1-mini,2931,231,3162
2025-08-12T08:36:10Z,sentiment,gpt-4.1-mini,1852,222,2074
2025-08-12T08:36:17Z,sentiment,gpt-4.1-mini,2754,115,2869
2025-08-12T08:36:19Z,sentiment,gpt-4.1-mini,4305,166,4471
2025-08-12T08:36:21Z,sentiment,gpt-4.1-mini,1946,100,2046
2025-08-12T08:36:23Z,sentiment,gpt-4.1-mini,3546,106,3652
2025-08-12T08:36:32Z,sentiment,gpt-4.1-mini,1734,239,1973
2025-08-12T08:36:34Z,sentiment,gpt-4.1-mini,1377,174,1551
2025-08-12T08:36:37Z,sentiment,gpt-4.1-mini,1414,172,1586
2025-08-12T08:36:41Z,sentiment,gpt-4.1-mini,1601,192,1793
2025-08-12T08:36:45Z,sentiment,gpt-4.1-mini,3912,233,4145
2025-08-12T08:36:48Z,sentiment,gpt-4.1-mini,1420,120,1540
2025-08-12T08:36:51Z,sentiment,gpt-4.1-mini,1671,174,1845
2025-08-12T08:36:57Z,sentiment,gpt-4.1-mini,1995,105,2100
2025-08-12T08:36:59Z,sentiment,gpt-4.1-mini,1388,133,1521
2025-08-12T08:37:08Z,sentiment,gpt-4.1-mini,1995,110,2105
2025-08-12T08:37:11Z,sentiment,gpt-4.1-mini,1388,134,1522
2025-08-12T08:37:29Z,sentiment,gpt-4.1-mini,1893,252,2145
2025-08-12T08:37:33Z,sentiment,gpt-4.1-mini,1741,188,1929
2025-08-12T08:37:40Z,sentiment,gpt-4.1-mini,1444,182,1626
2025-08-12T08:37:43Z,sentiment,gpt-4.1-mini,1444,171,1615
2025-08-12T08:37:56Z,sentiment,gpt-4.1-mini,1606,207,1813
2025-08-12T08:37:59Z,sentiment,gpt-4.1-mini,1444,120,1564
2025-08-12T08:38:03Z,sentiment,gpt-4.1-mini,1898,203,2101
2025-08-12T08:38:06Z,sentiment,gpt-4.1-mini,1426,210,1636
2025-08-12T08:38:08Z,sentiment,gpt-4.1-mini,1832,119,1951
2025-08-12T08:38:11Z,sentiment,gpt-4.1-mini,1414,119,1533
2025-08-12T08:38:20Z,sentiment,gpt-4.1-mini,1964,185,2149
2025-08-12T08:38:24Z,sentiment,gpt-4.1-mini,1540,173,1713
2025-08-12T08:38:27Z,sentiment,gpt-4.1-mini,2478,166,2644
2025-08-12T08:38:33Z,sentiment,gpt-4.1-mini,1551,229,1780
2025-08-12T08:38:41Z,sentiment,gpt-4.1-mini,1188,150,1338
2025-08-12T08:38:43Z,sentiment,gpt-4.1-mini,1488,141,1629
2025-08-12T08:38:49Z,article_selection,gpt-4.1-mini,1823,9,1832
2025-08-12T08:38:50Z,article_selection,gpt-4.1-mini,758,9,767
2025-08-12T08:38:50Z,article_selection,gpt-4.1-mini,615,7,622
2025-08-12T08:38:51Z,article_selection,gpt-4.1-mini,1307,12,1319
2025-08-12T06:39:00Z,RUN_TOTAL,,156856,14157,171013
2025-08-12T09:07:24Z,pre_sentiment,gpt-4.1-mini,291,1,292
2025-08-12T09:07:24Z,pre_sentiment,gpt-4.1-mini,288,1,289
2025-08-12T09:07:25Z,pre_sentiment,gpt-4.1-mini,274,1,275
2025-08-12T09:07:25Z,pre_sentiment,gpt-4.1-mini,294,1,295
2025-08-12T09:07:26Z,pre_sentiment,gpt-4.1-mini,279,1,280
2025-08-12T09:07:28Z,sentiment,gpt-4.1-mini,1218,118,1336
2025-08-12T09:07:29Z,pre_sentiment,gpt-4.1-mini,295,1,296
2025-08-12T09:07:32Z,sentiment,gpt-4.1-mini,2855,164,3019
2025-08-12T09:07:32Z,pre_sentiment,gpt-4.1-mini,285,1,286
2025-08-12T09:07:33Z,pre_sentiment,gpt-4.1-mini,282,1,283
2025-08-12T09:07:36Z,sentiment,gpt-4.1-mini,1674,169,1843
2025-08-12T09:07:36Z,pre_sentiment,gpt-4.1-mini,283,1,284
2025-08-12T09:07:37Z,pre_sentiment,gpt-4.1-mini,281,1,282
2025-08-12T09:07:37Z,pre_sentiment,gpt-4.1-mini,282,1,283
2025-08-12T09:07:42Z,sentiment,gpt-4.1-mini,1424,201,1625
2025-08-12T09:07:42Z,pre_sentiment,gpt-4.1-mini,283,1,284
2025-08-12T09:07:46Z,sentiment,gpt-4.1-mini,2298,182,2480
2025-08-12T09:07:47Z,pre_sentiment,gpt-4.1-mini,291,1,292
2025-08-12T09:07:47Z,pre_sentiment,gpt-4.1-mini,287,1,288
2025-08-12T09:07:55Z,pre_sentiment,gpt-4.1-mini,285,1,286
2025-08-12T09:07:55Z,pre_sentiment,gpt-4.1-mini,285,1,286
2025-08-12T09:07:55Z,pre_sentiment,gpt-4.1-mini,274,1,275
2025-08-12T09:07:56Z,pre_sentiment,gpt-4.1-mini,290,1,291
2025-08-12T09:08:01Z,sentiment,gpt-4.1-mini,1761,204,1965
2025-08-12T09:08:02Z,pre_sentiment,gpt-4.1-mini,280,1,281
2025-08-12T09:08:05Z,sentiment,gpt-4.1-mini,1064,132,1196
2025-08-12T09:08:06Z,pre_sentiment,gpt-4.1-mini,284,1,285
2025-08-12T09:08:10Z,sentiment,gpt-4.1-mini,1189,201,1390
2025-08-12T09:08:10Z,pre_sentiment,gpt-4.1-mini,284,1,285
2025-08-12T09:08:16Z,pre_sentiment,gpt-4.1-mini,283,1,284
2025-08-12T09:08:16Z,pre_sentiment,gpt-4.1-mini,280,1,281
2025-08-12T09:08:21Z,sentiment,gpt-4.1-mini,2901,207,3108
2025-08-12T09:08:22Z,pre_sentiment,gpt-4.1-mini,278,1,279
2025-08-12T09:08:25Z,sentiment,gpt-4.1-mini,1785,159,1944
2025-08-12T09:08:38Z,pre_sentiment,gpt-4.1-mini,284,1,285
2025-08-12T09:08:42Z,sentiment,gpt-4.1-mini,1535,188,1723
2025-08-12T09:08:43Z,pre_sentiment,gpt-4.1-mini,284,1,285
2025-08-12T09:08:47Z,sentiment,gpt-4.1-mini,1634,201,1835
2025-08-12T09:08:48Z,pre_sentiment,gpt-4.1-mini,281,1,282
2025-08-12T09:08:48Z,pre_sentiment,gpt-4.1-mini,290,1,291
2025-08-12T09:08:52Z,sentiment,gpt-4.1-mini,1304,163,1467
2025-08-12T09:08:52Z,pre_sentiment,gpt-4.1-mini,287,1,288
2025-08-12T09:08:53Z,pre_sentiment,gpt-4.1-mini,281,1,282
2025-08-12T09:08:57Z,sentiment,gpt-4.1-mini,1801,207,2008
2025-08-12T09:08:57Z,pre_sentiment,gpt-4.1-mini,284,1,285
2025-08-12T09:09:03Z,sentiment,gpt-4.1-mini,1709,192,1901
2025-08-12T09:09:04Z,pre_sentiment,gpt-4.1-mini,286,1,287
2025-08-12T09:09:07Z,sentiment,gpt-4.1-mini,1841,203,2044
2025-08-12T09:09:08Z,pre_sentiment,gpt-4.1-mini,279,1,280
2025-08-12T09:09:12Z,sentiment,gpt-4.1-mini,2019,215,2234
2025-08-12T09:09:21Z,pre_sentiment,gpt-4.1-mini,299,1,300
2025-08-12T09:09:24Z,sentiment,gpt-4.1-mini,1110,134,1244
2025-08-12T09:09:25Z,pre_sentiment,gpt-4.1-mini,304,1,305
2025-08-12T09:09:29Z,sentiment,gpt-4.1-mini,1153,195,1348
2025-08-12T09:09:30Z,pre_sentiment,gpt-4.1-mini,301,1,302
2025-08-12T09:09:32Z,sentiment,gpt-4.1-mini,1074,120,1194
2025-08-12T09:09:33Z,pre_sentiment,gpt-4.1-mini,300,1,301
2025-08-12T09:09:35Z,sentiment,gpt-4.1-mini,1109,147,1256
2025-08-12T09:09:36Z,pre_sentiment,gpt-4.1-mini,296,1,297
2025-08-12T09:09:40Z,sentiment,gpt-4.1-mini,3801,187,3988
2025-08-12T09:09:41Z,pre_sentiment,gpt-4.1-mini,292,1,293
2025-08-12T09:09:44Z,sentiment,gpt-4.1-mini,2220,156,2376
2025-08-12T09:09:44Z,pre_sentiment,gpt-4.1-mini,293,1,294
2025-08-12T09:09:47Z,sentiment,gpt-4.1-mini,910,103,1013
2025-08-12T09:09:47Z,pre_sentiment,gpt-4.1-mini,296,1,297
2025-08-12T09:09:48Z,pre_sentiment,gpt-4.1-mini,295,1,296
2025-08-12T09:09:53Z,sentiment,gpt-4.1-mini,1707,209,1916
2025-08-12T09:09:54Z,pre_sentiment,gpt-4.1-mini,294,1,295
2025-08-12T09:09:54Z,pre_sentiment,gpt-4.1-mini,298,1,299
2025-08-12T09:10:13Z,pre_sentiment,gpt-4.1-mini,289,1,290
2025-08-12T09:10:17Z,sentiment,gpt-4.1-mini,1327,132,1459
2025-08-12T09:10:17Z,pre_sentiment,gpt-4.1-mini,283,1,284
2025-08-12T09:10:20Z,sentiment,gpt-4.1-mini,1227,143,1370
2025-08-12T09:10:21Z,pre_sentiment,gpt-4.1-mini,282,1,283
2025-08-12T09:10:24Z,sentiment,gpt-4.1-mini,2027,179,2206
2025-08-12T09:10:25Z,pre_sentiment,gpt-4.1-mini,277,1,278
2025-08-12T09:10:30Z,sentiment,gpt-4.1-mini,1672,226,1898
2025-08-12T09:10:31Z,pre_sentiment,gpt-4.1-mini,283,1,284
2025-08-12T09:10:34Z,sentiment,gpt-4.1-mini,1580,202,1782
2025-08-12T09:10:35Z,pre_sentiment,gpt-4.1-mini,294,1,295
2025-08-12T09:10:40Z,sentiment,gpt-4.1-mini,1146,165,1311
2025-08-12T09:10:41Z,pre_sentiment,gpt-4.1-mini,284,1,285
2025-08-12T09:10:44Z,sentiment,gpt-4.1-mini,1359,140,1499
2025-08-12T09:10:54Z,pre_sentiment,gpt-4.1-mini,276,1,277
2025-08-12T09:11:01Z,sentiment,gpt-4.1-mini,2226,209,2435
2025-08-12T09:11:01Z,pre_sentiment,gpt-4.1-mini,299,1,300
2025-08-12T09:11:09Z,sentiment,gpt-4.1-mini,1263,213,1476
2025-08-12T09:11:10Z,pre_sentiment,gpt-4.1-mini,284,1,285
2025-08-12T09:11:16Z,sentiment,gpt-4.1-mini,3494,165,3659
2025-08-12T09:11:20Z,pre_sentiment,gpt-4.1-mini,286,1,287
2025-08-12T09:11:27Z,sentiment,gpt-4.1-mini,2952,207,3159
2025-08-12T09:11:27Z,pre_sentiment,gpt-4.1-mini,265,1,266
2025-08-12T09:11:35Z,sentiment,gpt-4.1-mini,1873,208,2081
2025-08-12T09:11:39Z,pre_sentiment,gpt-4.1-mini,274,1,275
2025-08-12T09:11:39Z,pre_sentiment,gpt-4.1-mini,276,1,277
2025-08-12T09:11:40Z,pre_sentiment,gpt-4.1-mini,274,1,275
2025-08-12T09:11:40Z,pre_sentiment,gpt-4.1-mini,275,1,276
2025-08-12T09:11:45Z,pre_sentiment,gpt-4.1-mini,285,1,286
2025-08-12T09:11:51Z,sentiment,gpt-4.1-mini,1755,211,1966
2025-08-12T09:11:51Z,pre_sentiment,gpt-4.1-mini,282,1,283
2025-08-12T09:11:55Z,sentiment,gpt-4.1-mini,1398,150,1548
2025-08-12T09:11:55Z,pre_sentiment,gpt-4.1-mini,285,1,286
2025-08-12T09:11:59Z,sentiment,gpt-4.1-mini,1435,146,1581
2025-08-12T09:12:00Z,pre_sentiment,gpt-4.1-mini,284,1,285
2025-08-12T09:12:06Z,sentiment,gpt-4.1-mini,1622,179,1801
2025-08-12T09:12:07Z,pre_sentiment,gpt-4.1-mini,283,1,284
2025-08-12T09:12:14Z,sentiment,gpt-4.1-mini,3933,236,4169
2025-08-12T09:12:15Z,pre_sentiment,gpt-4.1-mini,282,1,283
2025-08-12T09:12:15Z,pre_sentiment,gpt-4.1-mini,285,1,286
2025-08-12T09:12:19Z,sentiment,gpt-4.1-mini,1692,141,1833
2025-08-12T09:12:25Z,pre_sentiment,gpt-4.1-mini,283,1,284
2025-08-12T09:12:25Z,pre_sentiment,gpt-4.1-mini,285,1,286
2025-08-12T09:12:35Z,pre_sentiment,gpt-4.1-mini,283,1,284
2025-08-12T09:12:36Z,pre_sentiment,gpt-4.1-mini,285,1,286
2025-08-12T09:12:44Z,pre_sentiment,gpt-4.1-mini,288,1,289
2025-08-12T09:12:55Z,sentiment,gpt-4.1-mini,1914,290,2204
2025-08-12T09:12:56Z,pre_sentiment,gpt-4.1-mini,289,1,290
2025-08-12T09:13:03Z,sentiment,gpt-4.1-mini,1762,189,1951
2025-08-12T09:13:07Z,pre_sentiment,gpt-4.1-mini,298,1,299
2025-08-12T09:13:16Z,sentiment,gpt-4.1-mini,1465,190,1655
2025-08-12T09:13:18Z,pre_sentiment,gpt-4.1-mini,298,1,299
2025-08-12T09:13:24Z,sentiment,gpt-4.1-mini,1465,164,1629
2025-08-12T09:13:33Z,pre_sentiment,gpt-4.1-mini,293,1,294
2025-08-12T09:13:34Z,pre_sentiment,gpt-4.1-mini,287,1,288
2025-08-12T09:13:34Z,pre_sentiment,gpt-4.1-mini,284,1,285
2025-08-12T09:13:42Z,sentiment,gpt-4.1-mini,1919,201,2120
2025-08-12T09:13:42Z,pre_sentiment,gpt-4.1-mini,282,1,283
2025-08-12T09:13:49Z,sentiment,gpt-4.1-mini,1447,186,1633
2025-08-12T09:13:49Z,pre_sentiment,gpt-4.1-mini,294,1,295
2025-08-12T09:13:49Z,pre_sentiment,gpt-4.1-mini,280,1,281
2025-08-12T09:13:56Z,pre_sentiment,gpt-4.1-mini,283,1,284
2025-08-12T09:14:00Z,sentiment,gpt-4.1-mini,1985,159,2144
2025-08-12T09:14:01Z,pre_sentiment,gpt-4.1-mini,278,1,279
2025-08-12T09:14:06Z,sentiment,gpt-4.1-mini,1561,155,1716
2025-08-12T09:14:07Z,pre_sentiment,gpt-4.1-mini,287,1,288
2025-08-12T09:14:08Z,pre_sentiment,gpt-4.1-mini,289,1,290
2025-08-12T09:14:14Z,sentiment,gpt-4.1-mini,1572,223,1795
2025-08-12T09:14:20Z,pre_sentiment,gpt-4.1-mini,285,1,286
2025-08-12T09:14:24Z,sentiment,gpt-4.1-mini,1209,151,1360
2025-08-12T09:14:24Z,pre_sentiment,gpt-4.1-mini,279,1,280
2025-08-12T09:14:30Z,article_selection,gpt-4.1-mini,1482,9,1491
2025-08-12T09:14:30Z,article_selection,gpt-4.1-mini,661,12,673
2025-08-12T09:14:31Z,article_selection,gpt-4.1-mini,1183,18,1201
2025-08-12T09:14:36Z,article_selection,gpt-4.1-mini,764,12,776
2025-08-12T09:14:37Z,article_selection,gpt-4.1-mini,479,9,488
2025-08-12T09:14:52Z,final_summary_en,gpt-4.1-mini,1714,1306,3020
2025-08-12T09:15:11Z,final_summary_en,gpt-4.1-mini,1023,1036,2059
2025-08-12T09:15:27Z,final_summary_en,gpt-4.1-mini,2703,1200,3903
2025-08-12T09:15:43Z,final_summary_en,gpt-4.1-mini,1515,1181,2696
2025-08-12T09:16:00Z,final_summary_en,gpt-4.1-mini,1512,987,2499
2025-08-12T09:16:20Z,final_summary_en,gpt-4.1-mini,3543,1132,4675
2025-08-12T09:16:32Z,final_summary_en,gpt-4.1-mini,1202,1093,2295
2025-08-12T09:16:44Z,final_summary_en,gpt-4.1-mini,1335,1264,2599
2025-08-12T09:17:02Z,final_summary_en,gpt-4.1-mini,1286,1161,2447
2025-08-12T09:17:17Z,final_summary_en,gpt-4.1-mini,1436,1339,2775
2025-08-12T09:17:41Z,final_summary_en,gpt-4.1-mini,1371,1072,2443
2025-08-12T09:17:57Z,final_summary_en,gpt-4.1-mini,3707,1238,4945
2025-08-12T09:18:11Z,final_summary_en,gpt-4.1-mini,1556,865,2421
2025-08-12T09:18:31Z,final_summary_en,gpt-4.1-mini,1612,1138,2750
2025-08-12T09:18:47Z,final_summary_en,gpt-4.1-mini,1783,975,2758
2025-08-12T09:18:57Z,final_summary_en,gpt-4.1-mini,1474,1147,2621
2025-08-12T09:19:19Z,final_summary_en,gpt-4.1-mini,1338,1273,2611
2025-08-12T09:19:40Z,final_summary_en,gpt-4.1-mini,1678,1249,2927
2025-08-12T09:19:56Z,final_summary_en,gpt-4.1-mini,1194,1048,2242
2025-08-12T09:20:12Z,final_summary_en,gpt-4.1-mini,2668,1125,3793
2025-08-12T09:21:04Z,category_summary,gpt-4.1-mini,125,31,156
2025-08-12T09:21:06Z,category_summary,gpt-4.1-mini,144,33,177
2025-08-12T09:21:09Z,category_summary,gpt-4.1-mini,122,44,166
2025-08-12T09:21:11Z,category_summary,gpt-4.1-mini,137,35,172
2025-08-12T09:21:13Z,category_summary,gpt-4.1-mini,84,16,100
2025-08-12T09:21:14Z,category_summary,gpt-4.1-mini,115,41,156
2025-08-12T07:21:15Z,RUN_TOTAL,,159181,32693,191874
2025-08-13T04:32:40Z,pre_sentiment,gpt-4.1-mini,278,1,279
2025-08-13T04:32:41Z,pre_sentiment,gpt-4.1-mini,281,1,282
2025-08-13T04:32:42Z,pre_sentiment,gpt-4.1-mini,286,1,287
2025-08-13T04:32:42Z,pre_sentiment,gpt-4.1-mini,283,1,284
2025-08-13T04:32:43Z,pre_sentiment,gpt-4.1-mini,282,1,283
2025-08-13T04:32:46Z,sentiment,gpt-4.1-mini,2168,242,2410
2025-08-13T04:32:46Z,pre_sentiment,gpt-4.1-mini,284,1,285
2025-08-13T04:32:47Z,pre_sentiment,gpt-4.1-mini,285,1,286
2025-08-13T04:32:49Z,sentiment,gpt-4.1-mini,2112,263,2375
2025-08-13T04:32:50Z,pre_sentiment,gpt-4.1-mini,287,1,288
2025-08-13T04:32:50Z,pre_sentiment,gpt-4.1-mini,278,1,279
2025-08-13T04:32:51Z,pre_sentiment,gpt-4.1-mini,288,1,289
2025-08-13T04:32:54Z,sentiment,gpt-4.1-mini,2169,227,2396
2025-08-13T04:32:54Z,pre_sentiment,gpt-4.1-mini,289,1,290
2025-08-13T04:32:54Z,pre_sentiment,gpt-4.1-mini,289,1,290
2025-08-13T04:32:55Z,pre_sentiment,gpt-4.1-mini,284,1,285
2025-08-13T04:32:55Z,pre_sentiment,gpt-4.1-mini,289,1,290
2025-08-13T04:33:06Z,pre_sentiment,gpt-4.1-mini,278,1,279
2025-08-13T04:33:07Z,pre_sentiment,gpt-4.1-mini,280,1,281
2025-08-13T04:33:07Z,pre_sentiment,gpt-4.1-mini,288,1,289
2025-08-13T04:33:07Z,pre_sentiment,gpt-4.1-mini,284,1,285
2025-08-13T04:33:08Z,pre_sentiment,gpt-4.1-mini,282,1,283
2025-08-13T04:33:14Z,pre_sentiment,gpt-4.1-mini,283,1,284
2025-08-13T04:33:21Z,pre_sentiment,gpt-4.1-mini,285,1,286
2025-08-13T04:33:21Z,pre_sentiment,gpt-4.1-mini,281,1,282
2025-08-13T04:33:23Z,sentiment,gpt-4.1-mini,1759,200,1959
2025-08-13T04:33:24Z,pre_sentiment,gpt-4.1-mini,283,1,284
2025-08-13T04:33:26Z,sentiment,gpt-4.1-mini,1605,203,1808
2025-08-13T04:33:27Z,pre_sentiment,gpt-4.1-mini,281,1,282
2025-08-13T04:33:27Z,pre_sentiment,gpt-4.1-mini,278,1,279
2025-08-13T04:33:29Z,sentiment,gpt-4.1-mini,2279,197,2476
2025-08-13T04:33:29Z,pre_sentiment,gpt-4.1-mini,279,1,280
2025-08-13T04:33:32Z,sentiment,gpt-4.1-mini,1588,201,1789
2025-08-13T04:33:32Z,pre_sentiment,gpt-4.1-mini,279,1,280
2025-08-13T04:33:32Z,pre_sentiment,gpt-4.1-mini,284,1,285
2025-08-13T04:33:35Z,sentiment,gpt-4.1-mini,1634,201,1835
2025-08-13T04:33:52Z,pre_sentiment,gpt-4.1-mini,300,1,301
2025-08-13T04:33:53Z,sentiment,gpt-4.1-mini,919,117,1036
2025-08-13T04:33:53Z,pre_sentiment,gpt-4.1-mini,297,1,298
2025-08-13T04:33:56Z,sentiment,gpt-4.1-mini,905,107,1012
2025-08-13T04:33:56Z,pre_sentiment,gpt-4.1-mini,297,1,298
2025-08-13T04:33:58Z,sentiment,gpt-4.1-mini,905,82,987
2025-08-13T04:33:58Z,pre_sentiment,gpt-4.1-mini,292,1,293
2025-08-13T04:33:59Z,sentiment,gpt-4.1-mini,901,93,994
2025-08-13T04:33:59Z,pre_sentiment,gpt-4.1-mini,293,1,294
2025-08-13T04:34:01Z,sentiment,gpt-4.1-mini,901,90,991
2025-08-13T04:34:01Z,pre_sentiment,gpt-4.1-mini,297,1,298
2025-08-13T04:34:02Z,sentiment,gpt-4.1-mini,928,104,1032
2025-08-13T04:34:03Z,pre_sentiment,gpt-4.1-mini,299,1,300
2025-08-13T04:34:03Z,pre_sentiment,gpt-4.1-mini,300,1,301
2025-08-13T04:34:04Z,pre_sentiment,gpt-4.1-mini,297,1,298
2025-08-13T04:34:04Z,pre_sentiment,gpt-4.1-mini,298,1,299
2025-08-13T04:34:05Z,pre_sentiment,gpt-4.1-mini,302,1,303
2025-08-13T04:34:05Z,pre_sentiment,gpt-4.1-mini,305,1,306
2025-08-13T04:34:05Z,pre_sentiment,gpt-4.1-mini,299,1,300
2025-08-13T04:34:07Z,sentiment,gpt-4.1-mini,1110,119,1229
2025-08-13T04:34:08Z,pre_sentiment,gpt-4.1-mini,304,1,305
2025-08-13T04:34:09Z,sentiment,gpt-4.1-mini,1153,191,1344
2025-08-13T04:34:10Z,pre_sentiment,gpt-4.1-mini,301,1,302
2025-08-13T04:34:11Z,sentiment,gpt-4.1-mini,1074,123,1197
2025-08-13T04:34:30Z,pre_sentiment,gpt-4.1-mini,283,1,284
2025-08-13T04:34:33Z,sentiment,gpt-4.1-mini,1950,241,2191
2025-08-13T04:34:37Z,pre_sentiment,gpt-4.1-mini,291,1,292
2025-08-13T04:34:39Z,sentiment,gpt-4.1-mini,1431,143,1574
2025-08-13T04:34:39Z,pre_sentiment,gpt-4.1-mini,287,1,288
2025-08-13T04:34:41Z,sentiment,gpt-4.1-mini,2031,157,2188
2025-08-13T04:34:42Z,pre_sentiment,gpt-4.1-mini,290,1,291
2025-08-13T04:34:45Z,sentiment,gpt-4.1-mini,6549,277,6826
2025-08-13T04:34:46Z,pre_sentiment,gpt-4.1-mini,300,1,301
2025-08-13T04:34:48Z,sentiment,gpt-4.1-mini,1405,175,1580
2025-08-13T04:34:48Z,pre_sentiment,gpt-4.1-mini,281,1,282
2025-08-13T04:34:50Z,sentiment,gpt-4.1-mini,1275,152,1427
2025-08-13T04:34:50Z,pre_sentiment,gpt-4.1-mini,282,1,283
2025-08-13T04:34:52Z,sentiment,gpt-4.1-mini,2610,166,2776
2025-08-13T04:34:58Z,pre_sentiment,gpt-4.1-mini,284,1,285
2025-08-13T04:35:01Z,sentiment,gpt-4.1-mini,2235,191,2426
2025-08-13T04:35:01Z,pre_sentiment,gpt-4.1-mini,276,1,277
2025-08-13T04:35:04Z,sentiment,gpt-4.1-mini,2226,203,2429
2025-08-13T04:35:08Z,pre_sentiment,gpt-4.1-mini,271,1,272
2025-08-13T04:35:10Z,sentiment,gpt-4.1-mini,3717,179,3896
2025-08-13T04:35:11Z,pre_sentiment,gpt-4.1-mini,266,1,267
2025-08-13T04:35:11Z,pre_sentiment,gpt-4.1-mini,273,1,274
2025-08-13T04:35:14Z,sentiment,gpt-4.1-mini,1996,214,2210
2025-08-13T04:35:14Z,pre_sentiment,gpt-4.1-mini,266,1,267
2025-08-13T04:35:15Z,pre_sentiment,gpt-4.1-mini,270,1,271
2025-08-13T04:35:19Z,pre_sentiment,gpt-4.1-mini,278,1,279
2025-08-13T04:35:19Z,pre_sentiment,gpt-4.1-mini,276,1,277
2025-08-13T04:35:20Z,pre_sentiment,gpt-4.1-mini,274,1,275
2025-08-13T04:35:20Z,pre_sentiment,gpt-4.1-mini,276,1,277
2025-08-13T04:35:45Z,pre_sentiment,gpt-4.1-mini,285,1,286
2025-08-13T04:35:47Z,sentiment,gpt-4.1-mini,3133,172,3305
2025-08-13T04:35:47Z,pre_sentiment,gpt-4.1-mini,284,1,285
2025-08-13T04:35:49Z,sentiment,gpt-4.1-mini,1544,170,1714
2025-08-13T04:35:50Z,pre_sentiment,gpt-4.1-mini,284,1,285
2025-08-13T04:35:52Z,sentiment,gpt-4.1-mini,1393,182,1575
2025-08-13T04:35:52Z,pre_sentiment,gpt-4.1-mini,283,1,284
2025-08-13T04:35:55Z,sentiment,gpt-4.1-mini,3209,242,3451
2025-08-13T04:35:55Z,pre_sentiment,gpt-4.1-mini,278,1,279
2025-08-13T04:35:55Z,pre_sentiment,gpt-4.1-mini,282,1,283
2025-08-13T04:35:57Z,sentiment,gpt-4.1-mini,1748,204,1952
2025-08-13T04:35:57Z,pre_sentiment,gpt-4.1-mini,279,1,280
2025-08-13T04:37:31Z,pre_sentiment,gpt-4.1-mini,289,1,290
2025-08-13T04:37:57Z,sentiment,gpt-4.1-mini,1762,181,1943
2025-08-13T04:38:15Z,pre_sentiment,gpt-4.1-mini,292,1,293
2025-08-13T04:38:15Z,pre_sentiment,gpt-4.1-mini,280,1,281
2025-08-13T04:38:15Z,pre_sentiment,gpt-4.1-mini,285,1,286
2025-08-13T04:38:17Z,sentiment,gpt-4.1-mini,1635,136,1771
2025-08-13T04:38:18Z,pre_sentiment,gpt-4.1-mini,287,1,288
2025-08-13T04:38:18Z,pre_sentiment,gpt-4.1-mini,280,1,281
2025-08-13T04:38:18Z,pre_sentiment,gpt-4.1-mini,284,1,285
2025-08-13T04:38:18Z,pre_sentiment,gpt-4.1-mini,289,1,290
2025-08-13T04:38:19Z,pre_sentiment,gpt-4.1-mini,282,1,283
2025-08-13T04:38:35Z,pre_sentiment,gpt-4.1-mini,289,1,290
2025-08-13T04:38:35Z,pre_sentiment,gpt-4.1-mini,287,1,288
2025-08-13T04:38:36Z,pre_sentiment,gpt-4.1-mini,283,1,284
2025-08-13T04:38:38Z,sentiment,gpt-4.1-mini,1985,172,2157
2025-08-13T04:38:54Z,pre_sentiment,gpt-4.1-mini,285,1,286
2025-08-13T04:38:54Z,pre_sentiment,gpt-4.1-mini,284,1,285
2025-08-13T04:38:57Z,sentiment,gpt-4.1-mini,1100,211,1311
2025-08-13T04:38:57Z,pre_sentiment,gpt-4.1-mini,283,1,284
2025-08-13T04:38:58Z,pre_sentiment,gpt-4.1-mini,282,1,283
2025-08-13T04:38:58Z,pre_sentiment,gpt-4.1-mini,284,1,285
2025-08-13T04:39:01Z,sentiment,gpt-4.1-mini,1087,166,1253
2025-08-13T04:39:01Z,pre_sentiment,gpt-4.1-mini,285,1,286
2025-08-13T04:39:03Z,sentiment,gpt-4.1-mini,1136,137,1273
2025-08-13T04:39:03Z,pre_sentiment,gpt-4.1-mini,284,1,285
2025-08-13T04:39:04Z,pre_sentiment,gpt-4.1-mini,284,1,285
2025-08-13T04:39:06Z,sentiment,gpt-4.1-mini,1145,137,1282
2025-08-13T04:39:15Z,article_selection,gpt-4.1-mini,1236,16,1252
2025-08-13T04:39:16Z,article_selection,gpt-4.1-mini,1195,16,1211
2025-08-13T04:39:17Z,article_selection,gpt-4.1-mini,363,5,368
2025-08-13T04:39:25Z,final_summary_en,gpt-4.1-mini,1341,1114,2455
2025-08-13T04:39:40Z,final_summary_en,gpt-4.1-mini,1512,1109,2621
2025-08-13T04:39:47Z,final_summary_en,gpt-4.1-mini,2028,1011,3039
2025-08-13T04:39:59Z,final_summary_en,gpt-4.1-mini,1505,1051,2556
2025-08-13T04:40:09Z,final_summary_en,gpt-4.1-mini,6325,1461,7786
2025-08-13T04:40:24Z,final_summary_en,gpt-4.1-mini,1951,1065,3016
2025-08-13T04:40:41Z,final_summary_en,gpt-4.1-mini,1720,1207,2927
2025-08-13T04:41:08Z,final_summary_en,gpt-4.1-mini,1993,1254,3247
2025-08-13T04:41:34Z,final_summary_en,gpt-4.1-mini,1939,1387,3326
2025-08-13T04:41:56Z,final_summary_en,gpt-4.1-mini,1766,1223,2989
2025-08-13T04:42:10Z,final_summary_en,gpt-4.1-mini,1138,1100,2238
2025-08-13T04:42:26Z,final_summary_en,gpt-4.1-mini,1140,965,2105
2025-08-13T04:42:47Z,final_summary_en,gpt-4.1-mini,2994,1336,4330
2025-08-13T04:43:31Z,category_summary,gpt-4.1-mini,126,26,152
2025-08-13T04:43:34Z,category_summary,gpt-4.1-mini,138,41,179
2025-08-13T04:43:37Z,category_summary,gpt-4.1-mini,86,21,107
2025-08-13T04:43:40Z,category_summary,gpt-4.1-mini,88,26,114
2025-08-13T04:43:42Z,category_summary,gpt-4.1-mini,95,23,118
2025-08-13T04:43:44Z,category_summary,gpt-4.1-mini,110,22,132
2025-08-13T04:43:46Z,RUN_TOTAL,,128307,22535,150842
2025-08-14T04:32:35Z,pre_sentiment,gpt-4.1-mini,287,1,288
2025-08-14T04:32:36Z,pre_sentiment,gpt-4.1-mini,283,1,284
2025-08-14T04:32:36Z,pre_sentiment,gpt-4.1-mini,284,1,285
2025-08-14T04:32:39Z,sentiment,gpt-4.1-mini,1389,193,1582
2025-08-14T04:32:39Z,pre_sentiment,gpt-4.1-mini,281,1,282
2025-08-14T04:32:41Z,pre_sentiment,gpt-4.1-mini,286,1,287
2025-08-14T04:32:41Z,pre_sentiment,gpt-4.1-mini,286,1,287
2025-08-14T04:32:43Z,sentiment,gpt-4.1-mini,1272,172,1444
2025-08-14T04:32:44Z,pre_sentiment,gpt-4.1-mini,285,1,286
2025-08-14T04:32:44Z,pre_sentiment,gpt-4.1-mini,283,1,284
2025-08-14T04:32:46Z,sentiment,gpt-4.1-mini,1200,135,1335
2025-08-14T04:32:46Z,pre_sentiment,gpt-4.1-mini,280,1,281
2025-08-14T04:32:47Z,pre_sentiment,gpt-4.1-mini,281,1,282
2025-08-14T04:32:47Z,pre_sentiment,gpt-4.1-mini,283,1,284
2025-08-14T04:32:48Z,pre_sentiment,gpt-4.1-mini,284,1,285
2025-08-14T04:32:48Z,pre_sentiment,gpt-4.1-mini,287,1,288
2025-08-14T04:32:48Z,pre_sentiment,gpt-4.1-mini,285,1,286
2025-08-14T04:32:56Z,pre_sentiment,gpt-4.1-mini,280,1,281
2025-08-14T04:32:56Z,pre_sentiment,gpt-4.1-mini,276,1,277
2025-08-14T04:32:56Z,pre_sentiment,gpt-4.1-mini,289,1,290
2025-08-14T04:32:56Z,pre_sentiment,gpt-4.1-mini,278,1,279
2025-08-14T04:32:57Z,pre_sentiment,gpt-4.1-mini,280,1,281
2025-08-14T04:32:57Z,pre_sentiment,gpt-4.1-mini,285,1,286
2025-08-14T04:33:00Z,sentiment,gpt-4.1-mini,2233,238,2471
2025-08-14T04:33:05Z,pre_sentiment,gpt-4.1-mini,281,1,282
2025-08-14T04:33:10Z,pre_sentiment,gpt-4.1-mini,277,1,278
2025-08-14T04:33:13Z,sentiment,gpt-4.1-mini,2866,194,3060
2025-08-14T04:33:13Z,pre_sentiment,gpt-4.1-mini,282,1,283
2025-08-14T04:33:15Z,sentiment,gpt-4.1-mini,1846,199,2045
2025-08-14T04:33:16Z,pre_sentiment,gpt-4.1-mini,285,1,286
2025-08-14T04:33:19Z,sentiment,gpt-4.1-mini,1409,213,1622
2025-08-14T04:33:19Z,pre_sentiment,gpt-4.1-mini,281,1,282
2025-08-14T04:33:21Z,sentiment,gpt-4.1-mini,1764,186,1950
2025-08-14T04:33:21Z,pre_sentiment,gpt-4.1-mini,287,1,288
2025-08-14T04:33:24Z,sentiment,gpt-4.1-mini,2106,233,2339
2025-08-14T04:33:24Z,pre_sentiment,gpt-4.1-mini,288,1,289
2025-08-14T04:33:26Z,sentiment,gpt-4.1-mini,1695,214,1909
2025-08-14T04:33:27Z,pre_sentiment,gpt-4.1-mini,286,1,287
2025-08-14T04:33:29Z,sentiment,gpt-4.1-mini,1904,194,2098
2025-08-14T04:33:29Z,pre_sentiment,gpt-4.1-mini,285,1,286
2025-08-14T04:33:33Z,sentiment,gpt-4.1-mini,1548,199,1747
2025-08-14T04:33:33Z,pre_sentiment,gpt-4.1-mini,277,1,278
2025-08-14T04:33:36Z,sentiment,gpt-4.1-mini,2152,202,2354
2025-08-14T04:33:36Z,pre_sentiment,gpt-4.1-mini,282,1,283
2025-08-14T04:33:38Z,sentiment,gpt-4.1-mini,1639,216,1855
2025-08-14T04:33:39Z,pre_sentiment,gpt-4.1-mini,283,1,284
2025-08-14T04:33:41Z,sentiment,gpt-4.1-mini,1765,202,1967
2025-08-14T04:33:42Z,pre_sentiment,gpt-4.1-mini,286,1,287
2025-08-14T04:33:42Z,pre_sentiment,gpt-4.1-mini,277,1,278
2025-08-14T04:33:45Z,sentiment,gpt-4.1-mini,1328,190,1518
2025-08-14T04:33:45Z,pre_sentiment,gpt-4.1-mini,282,1,283
2025-08-14T04:33:48Z,sentiment,gpt-4.1-mini,2102,225,2327
2025-08-14T04:34:03Z,pre_sentiment,gpt-4.1-mini,298,1,299
2025-08-14T04:34:04Z,sentiment,gpt-4.1-mini,914,77,991
2025-08-14T04:34:04Z,pre_sentiment,gpt-4.1-mini,293,1,294
2025-08-14T04:34:05Z,sentiment,gpt-4.1-mini,901,84,985
2025-08-14T04:34:06Z,pre_sentiment,gpt-4.1-mini,293,1,294
2025-08-14T04:34:08Z,sentiment,gpt-4.1-mini,1358,179,1537
2025-08-14T04:34:08Z,pre_sentiment,gpt-4.1-mini,300,1,301
2025-08-14T04:34:10Z,sentiment,gpt-4.1-mini,919,91,1010
2025-08-14T04:34:11Z,pre_sentiment,gpt-4.1-mini,291,1,292
2025-08-14T04:34:11Z,pre_sentiment,gpt-4.1-mini,294,1,295
2025-08-14T04:34:13Z,sentiment,gpt-4.1-mini,2518,136,2654
2025-08-14T04:34:13Z,pre_sentiment,gpt-4.1-mini,291,1,292
2025-08-14T04:34:15Z,sentiment,gpt-4.1-mini,1014,98,1112
2025-08-14T04:34:15Z,pre_sentiment,gpt-4.1-mini,303,1,304
2025-08-14T04:34:18Z,sentiment,gpt-4.1-mini,2903,179,3082
2025-08-14T04:34:19Z,pre_sentiment,gpt-4.1-mini,299,1,300
2025-08-14T04:34:21Z,sentiment,gpt-4.1-mini,8353,186,8539
2025-08-14T04:34:21Z,pre_sentiment,gpt-4.1-mini,317,1,318
2025-08-14T04:34:24Z,sentiment,gpt-4.1-mini,5950,199,6149
2025-08-14T04:34:25Z,pre_sentiment,gpt-4.1-mini,301,1,302
2025-08-14T04:34:27Z,sentiment,gpt-4.1-mini,11285,226,11511
2025-08-14T04:34:28Z,pre_sentiment,gpt-4.1-mini,297,1,298
2025-08-14T04:34:30Z,sentiment,gpt-4.1-mini,4661,209,4870
2025-08-14T04:34:30Z,pre_sentiment,gpt-4.1-mini,299,1,300
2025-08-14T04:34:33Z,sentiment,gpt-4.1-mini,12868,280,13148
2025-08-14T04:34:33Z,pre_sentiment,gpt-4.1-mini,299,1,300
2025-08-14T04:34:38Z,sentiment,gpt-4.1-mini,8098,201,8299
2025-08-14T04:34:38Z,pre_sentiment,gpt-4.1-mini,297,1,298
2025-08-14T04:34:41Z,sentiment,gpt-4.1-mini,5207,205,5412
2025-08-14T04:34:56Z,pre_sentiment,gpt-4.1-mini,300,1,301
2025-08-14T04:34:56Z,pre_sentiment,gpt-4.1-mini,278,1,279
2025-08-14T04:34:58Z,sentiment,gpt-4.1-mini,1076,178,1254
2025-08-14T04:34:58Z,pre_sentiment,gpt-4.1-mini,280,1,281
2025-08-14T04:35:01Z,sentiment,gpt-4.1-mini,1676,155,1831
2025-08-14T04:35:01Z,pre_sentiment,gpt-4.1-mini,294,1,295
2025-08-14T04:35:03Z,sentiment,gpt-4.1-mini,1921,219,2140
2025-08-14T04:35:04Z,pre_sentiment,gpt-4.1-mini,280,1,281
2025-08-14T04:35:05Z,sentiment,gpt-4.1-mini,980,135,1115
2025-08-14T04:35:06Z,pre_sentiment,gpt-4.1-mini,286,1,287
2025-08-14T04:35:08Z,sentiment,gpt-4.1-mini,2156,166,2322
2025-08-14T04:35:08Z,pre_sentiment,gpt-4.1-mini,286,1,287
2025-08-14T04:35:11Z,sentiment,gpt-4.1-mini,1798,206,2004
2025-08-14T04:35:11Z,pre_sentiment,gpt-4.1-mini,295,1,296
2025-08-14T04:35:14Z,sentiment,gpt-4.1-mini,2494,225,2719
2025-08-14T04:35:14Z,pre_sentiment,gpt-4.1-mini,279,1,280
2025-08-14T04:35:16Z,sentiment,gpt-4.1-mini,1262,178,1440
2025-08-14T04:35:17Z,pre_sentiment,gpt-4.1-mini,285,1,286
2025-08-14T04:35:19Z,sentiment,gpt-4.1-mini,1252,181,1433
2025-08-14T04:35:23Z,pre_sentiment,gpt-4.1-mini,292,1,293
2025-08-14T04:35:25Z,sentiment,gpt-4.1-mini,1156,174,1330
2025-08-14T04:35:26Z,pre_sentiment,gpt-4.1-mini,280,1,281
2025-08-14T04:35:27Z,sentiment,gpt-4.1-mini,1874,165,2039
2025-08-14T04:35:32Z,pre_sentiment,gpt-4.1-mini,270,1,271
2025-08-14T04:35:32Z,pre_sentiment,gpt-4.1-mini,270,1,271
2025-08-14T04:35:35Z,sentiment,gpt-4.1-mini,2834,235,3069
2025-08-14T04:35:35Z,pre_sentiment,gpt-4.1-mini,287,1,288
2025-08-14T04:35:44Z,sentiment,gpt-4.1-mini,2156,229,2385
2025-08-14T04:35:44Z,pre_sentiment,gpt-4.1-mini,260,1,261
2025-08-14T04:35:48Z,pre_sentiment,gpt-4.1-mini,278,1,279
2025-08-14T04:35:49Z,pre_sentiment,gpt-4.1-mini,283,1,284
2025-08-14T04:35:49Z,pre_sentiment,gpt-4.1-mini,277,1,278
2025-08-14T04:35:50Z,sentiment,gpt-4.1-mini,2304,117,2421
2025-08-14T04:35:57Z,pre_sentiment,gpt-4.1-mini,285,1,286
2025-08-14T04:35:59Z,sentiment,gpt-4.1-mini,1453,181,1634
2025-08-14T04:36:00Z,pre_sentiment,gpt-4.1-mini,286,1,287
2025-08-14T04:36:02Z,sentiment,gpt-4.1-mini,1733,208,1941
2025-08-14T04:36:03Z,pre_sentiment,gpt-4.1-mini,278,1,279
2025-08-14T04:36:05Z,sentiment,gpt-4.1-mini,1397,179,1576
2025-08-14T04:36:05Z,pre_sentiment,gpt-4.1-mini,284,1,285
2025-08-14T04:36:05Z,pre_sentiment,gpt-4.1-mini,285,1,286
2025-08-14T04:36:08Z,sentiment,gpt-4.1-mini,4403,169,4572
2025-08-14T04:36:08Z,pre_sentiment,gpt-4.1-mini,282,1,283
2025-08-14T04:36:10Z,sentiment,gpt-4.1-mini,1481,182,1663
2025-08-14T04:36:10Z,pre_sentiment,gpt-4.1-mini,287,1,288
2025-08-14T04:36:13Z,sentiment,gpt-4.1-mini,1605,191,1796
2025-08-14T04:36:13Z,pre_sentiment,gpt-4.1-mini,281,1,282
2025-08-14T04:36:14Z,pre_sentiment,gpt-4.1-mini,279,1,280
2025-08-14T04:36:14Z,pre_sentiment,gpt-4.1-mini,285,1,286
2025-08-14T04:36:14Z,pre_sentiment,gpt-4.1-mini,282,1,283
2025-08-14T04:36:17Z,sentiment,gpt-4.1-mini,1771,186,1957
2025-08-14T04:36:24Z,pre_sentiment,gpt-4.1-mini,281,1,282
2025-08-14T04:36:24Z,pre_sentiment,gpt-4.1-mini,291,1,292
2025-08-14T04:36:25Z,pre_sentiment,gpt-4.1-mini,284,1,285
2025-08-14T04:36:42Z,pre_sentiment,gpt-4.1-mini,281,1,282
2025-08-14T04:36:42Z,pre_sentiment,gpt-4.1-mini,291,1,292
2025-08-14T04:36:43Z,pre_sentiment,gpt-4.1-mini,284,1,285
2025-08-14T04:36:59Z,pre_sentiment,gpt-4.1-mini,287,1,288
2025-08-14T04:37:01Z,sentiment,gpt-4.1-mini,1721,187,1908
2025-08-14T04:37:02Z,pre_sentiment,gpt-4.1-mini,289,1,290
2025-08-14T04:37:04Z,sentiment,gpt-4.1-mini,1589,144,1733
2025-08-14T04:37:04Z,pre_sentiment,gpt-4.1-mini,290,1,291
2025-08-14T04:37:06Z,sentiment,gpt-4.1-mini,1765,153,1918
2025-08-14T04:37:06Z,pre_sentiment,gpt-4.1-mini,286,1,287
2025-08-14T04:37:09Z,sentiment,gpt-4.1-mini,1899,196,2095
2025-08-14T04:37:20Z,pre_sentiment,gpt-4.1-mini,298,1,299
2025-08-14T04:37:21Z,pre_sentiment,gpt-4.1-mini,288,1,289
2025-08-14T04:37:23Z,sentiment,gpt-4.1-mini,1441,178,1619
2025-08-14T04:37:23Z,pre_sentiment,gpt-4.1-mini,282,1,283
2025-08-14T04:37:23Z,pre_sentiment,gpt-4.1-mini,292,1,293
2025-08-14T04:37:24Z,pre_sentiment,gpt-4.1-mini,288,1,289
2025-08-14T04:37:24Z,pre_sentiment,gpt-4.1-mini,279,1,280
2025-08-14T04:37:26Z,sentiment,gpt-4.1-mini,1335,187,1522
2025-08-14T04:37:26Z,pre_sentiment,gpt-4.1-mini,288,1,289
2025-08-14T04:37:27Z,pre_sentiment,gpt-4.1-mini,286,1,287
2025-08-14T04:37:29Z,sentiment,gpt-4.1-mini,1319,190,1509
2025-08-14T04:37:41Z,pre_sentiment,gpt-4.1-mini,288,1,289
2025-08-14T04:37:43Z,sentiment,gpt-4.1-mini,2511,229,2740
2025-08-14T04:37:44Z,pre_sentiment,gpt-4.1-mini,285,1,286
2025-08-14T04:37:44Z,pre_sentiment,gpt-4.1-mini,289,1,290
2025-08-14T04:37:47Z,sentiment,gpt-4.1-mini,1675,201,1876
2025-08-14T04:37:59Z,pre_sentiment,gpt-4.1-mini,287,1,288
2025-08-14T04:37:59Z,pre_sentiment,gpt-4.1-mini,281,1,282
2025-08-14T04:37:59Z,pre_sentiment,gpt-4.1-mini,291,1,292
2025-08-14T04:37:59Z,pre_sentiment,gpt-4.1-mini,287,1,288
2025-08-14T04:38:00Z,pre_sentiment,gpt-4.1-mini,286,1,287
2025-08-14T04:38:00Z,pre_sentiment,gpt-4.1-mini,284,1,285
2025-08-14T04:38:02Z,sentiment,gpt-4.1-mini,2438,210,2648
2025-08-14T04:38:09Z,pre_sentiment,gpt-4.1-mini,305,1,306
2025-08-14T04:38:12Z,sentiment,gpt-4.1-mini,1536,217,1753
2025-08-14T04:38:13Z,article_selection,gpt-4.1-mini,1870,12,1882
2025-08-14T04:38:14Z,article_selection,gpt-4.1-mini,1037,9,1046
2025-08-14T04:38:14Z,article_selection,gpt-4.1-mini,2167,16,2183
2025-08-14T04:38:14Z,article_selection,gpt-4.1-mini,956,9,965
2025-08-14T04:38:15Z,article_selection,gpt-4.1-mini,752,12,764
2025-08-14T04:38:15Z,article_selection,gpt-4.1-mini,430,6,436
2025-08-14T04:38:16Z,article_selection,gpt-4.1-mini,834,12,846
2025-08-14T04:38:27Z,final_summary_en,gpt-4.1-mini,1142,1158,2300
2025-08-14T04:38:41Z,final_summary_en,gpt-4.1-mini,1156,1104,2260
2025-08-14T04:38:54Z,final_summary_en,gpt-4.1-mini,1542,1315,2857
2025-08-14T04:39:06Z,final_summary_en,gpt-4.1-mini,1649,1205,2854
2025-08-14T04:39:16Z,final_summary_en,gpt-4.1-mini,1879,1140,3019
2025-08-14T04:39:27Z,final_summary_en,gpt-4.1-mini,1608,1093,2701
2025-08-14T04:39:39Z,final_summary_en,gpt-4.1-mini,1400,1090,2490
2025-08-14T04:39:52Z,final_summary_en,gpt-4.1-mini,1135,1118,2253
2025-08-14T04:40:05Z,final_summary_en,gpt-4.1-mini,1868,1124,2992
2025-08-14T04:40:19Z,final_summary_en,gpt-4.1-mini,2639,1008,3647
2025-08-14T04:40:32Z,final_summary_en,gpt-4.1-mini,1932,1166,3098
2025-08-14T04:40:44Z,final_summary_en,gpt-4.1-mini,1302,1217,2519
2025-08-14T04:40:57Z,final_summary_en,gpt-4.1-mini,1907,1369,3276
2025-08-14T04:41:10Z,final_summary_en,gpt-4.1-mini,1464,1180,2644
2025-08-14T04:41:21Z,final_summary_en,gpt-4.1-mini,1643,1176,2819
2025-08-14T04:41:33Z,final_summary_en,gpt-4.1-mini,1288,1224,2512
2025-08-14T04:41:44Z,final_summary_en,gpt-4.1-mini,5713,1168,6881
2025-08-14T04:42:00Z,final_summary_en,gpt-4.1-mini,997,1080,2077
2025-08-14T04:42:11Z,final_summary_en,gpt-4.1-mini,1522,1150,2672
2025-08-14T04:42:19Z,final_summary_en,gpt-4.1-mini,1086,856,1942
2025-08-14T04:42:28Z,final_summary_en,gpt-4.1-mini,1008,988,1996
2025-08-14T04:42:41Z,final_summary_en,gpt-4.1-mini,1015,1099,2114
2025-08-14T04:42:57Z,final_summary_en,gpt-4.1-mini,2596,1285,3881
2025-08-14T04:43:09Z,final_summary_en,gpt-4.1-mini,2292,1255,3547
2025-08-14T04:43:20Z,final_summary_en,gpt-4.1-mini,1423,1156,2579
2025-08-14T04:43:32Z,final_summary_en,gpt-4.1-mini,1075,937,2012
2025-08-14T04:45:10Z,category_summary,gpt-4.1-mini,137,35,172
2025-08-14T04:45:11Z,category_summary,gpt-4.1-mini,134,23,157
2025-08-14T04:45:13Z,category_summary,gpt-4.1-mini,131,28,159
2025-08-14T04:45:15Z,category_summary,gpt-4.1-mini,141,37,178
2025-08-14T04:45:17Z,category_summary,gpt-4.1-mini,129,38,167
2025-08-14T04:45:18Z,category_summary,gpt-4.1-mini,142,23,165
2025-08-14T04:45:19Z,RUN_TOTAL,,239215,41735,280950
2025-08-15T04:33:09Z,pre_sentiment,gpt-4.1-mini,287,1,288
2025-08-15T04:33:10Z,pre_sentiment,gpt-4.1-mini,285,1,286
2025-08-15T04:33:10Z,pre_sentiment,gpt-4.1-mini,289,1,290
2025-08-15T04:33:11Z,pre_sentiment,gpt-4.1-mini,285,1,286
2025-08-15T04:33:13Z,sentiment,gpt-4.1-mini,1765,148,1913
2025-08-15T04:33:13Z,pre_sentiment,gpt-4.1-mini,281,1,282
2025-08-15T04:33:15Z,sentiment,gpt-4.1-mini,1653,187,1840
2025-08-15T04:33:16Z,pre_sentiment,gpt-4.1-mini,291,1,292
2025-08-15T04:33:16Z,pre_sentiment,gpt-4.1-mini,281,1,282
2025-08-15T04:33:19Z,sentiment,gpt-4.1-mini,1592,157,1749
2025-08-15T04:33:19Z,pre_sentiment,gpt-4.1-mini,282,1,283
2025-08-15T04:33:19Z,pre_sentiment,gpt-4.1-mini,284,1,285
2025-08-15T04:33:20Z,pre_sentiment,gpt-4.1-mini,286,1,287
2025-08-15T04:33:22Z,sentiment,gpt-4.1-mini,1444,201,1645
2025-08-15T04:33:23Z,pre_sentiment,gpt-4.1-mini,283,1,284
2025-08-15T04:33:24Z,sentiment,gpt-4.1-mini,1290,139,1429
2025-08-15T04:33:25Z,pre_sentiment,gpt-4.1-mini,287,1,288
2025-08-15T04:33:25Z,pre_sentiment,gpt-4.1-mini,286,1,287
2025-08-15T04:33:25Z,pre_sentiment,gpt-4.1-mini,281,1,282
2025-08-15T04:33:25Z,pre_sentiment,gpt-4.1-mini,286,1,287
2025-08-15T04:33:34Z,pre_sentiment,gpt-4.1-mini,285,1,286
2025-08-15T04:33:36Z,sentiment,gpt-4.1-mini,1765,123,1888
2025-08-15T04:33:36Z,pre_sentiment,gpt-4.1-mini,281,1,282
2025-08-15T04:33:38Z,sentiment,gpt-4.1-mini,1083,211,1294
2025-08-15T04:33:38Z,pre_sentiment,gpt-4.1-mini,278,1,279
2025-08-15T04:33:45Z,pre_sentiment,gpt-4.1-mini,286,1,287
2025-08-15T04:33:50Z,pre_sentiment,gpt-4.1-mini,287,1,288
2025-08-15T04:33:53Z,sentiment,gpt-4.1-mini,1464,183,1647
2025-08-15T04:33:53Z,pre_sentiment,gpt-4.1-mini,284,1,285
2025-08-15T04:33:57Z,sentiment,gpt-4.1-mini,1538,237,1775
2025-08-15T04:33:57Z,pre_sentiment,gpt-4.1-mini,279,1,280
2025-08-15T04:34:03Z,sentiment,gpt-4.1-mini,2210,237,2447
2025-08-15T04:34:03Z,pre_sentiment,gpt-4.1-mini,282,1,283
2025-08-15T04:34:06Z,sentiment,gpt-4.1-mini,1417,186,1603
2025-08-15T04:34:06Z,pre_sentiment,gpt-4.1-mini,279,1,280
2025-08-15T04:34:08Z,sentiment,gpt-4.1-mini,2152,192,2344
2025-08-15T04:34:08Z,pre_sentiment,gpt-4.1-mini,285,1,286
2025-08-15T04:34:09Z,pre_sentiment,gpt-4.1-mini,279,1,280
2025-08-15T04:34:11Z,sentiment,gpt-4.1-mini,1497,200,1697
2025-08-15T04:34:12Z,pre_sentiment,gpt-4.1-mini,284,1,285
2025-08-15T04:34:14Z,sentiment,gpt-4.1-mini,1949,223,2172
2025-08-15T04:34:15Z,pre_sentiment,gpt-4.1-mini,277,1,278
2025-08-15T04:34:17Z,sentiment,gpt-4.1-mini,2866,193,3059
2025-08-15T04:34:31Z,pre_sentiment,gpt-4.1-mini,297,1,298
2025-08-15T04:34:33Z,sentiment,gpt-4.1-mini,919,120,1039
2025-08-15T04:34:33Z,pre_sentiment,gpt-4.1-mini,300,1,301
2025-08-15T04:34:33Z,pre_sentiment,gpt-4.1-mini,297,1,298
2025-08-15T04:34:36Z,sentiment,gpt-4.1-mini,1481,209,1690
2025-08-15T04:34:36Z,pre_sentiment,gpt-4.1-mini,300,1,301
2025-08-15T04:34:38Z,sentiment,gpt-4.1-mini,2003,151,2154
2025-08-15T04:34:38Z,pre_sentiment,gpt-4.1-mini,296,1,297
2025-08-15T04:34:39Z,pre_sentiment,gpt-4.1-mini,303,1,304
2025-08-15T04:34:41Z,sentiment,gpt-4.1-mini,1665,168,1833
2025-08-15T04:34:41Z,pre_sentiment,gpt-4.1-mini,298,1,299
2025-08-15T04:34:42Z,sentiment,gpt-4.1-mini,914,84,998
2025-08-15T04:34:42Z,pre_sentiment,gpt-4.1-mini,293,1,294
2025-08-15T04:34:44Z,sentiment,gpt-4.1-mini,901,82,983
2025-08-15T04:34:44Z,pre_sentiment,gpt-4.1-mini,293,1,294
2025-08-15T04:34:46Z,sentiment,gpt-4.1-mini,1358,192,1550
2025-08-15T04:34:46Z,pre_sentiment,gpt-4.1-mini,300,1,301
2025-08-15T04:34:47Z,sentiment,gpt-4.1-mini,919,109,1028
2025-08-15T04:34:47Z,pre_sentiment,gpt-4.1-mini,291,1,292
2025-08-15T04:34:48Z,pre_sentiment,gpt-4.1-mini,294,1,295
2025-08-15T04:34:49Z,sentiment,gpt-4.1-mini,2518,140,2658
2025-08-15T04:34:50Z,pre_sentiment,gpt-4.1-mini,291,1,292
2025-08-15T04:34:51Z,sentiment,gpt-4.1-mini,1014,125,1139
2025-08-15T04:34:52Z,pre_sentiment,gpt-4.1-mini,299,1,300
2025-08-15T04:34:55Z,sentiment,gpt-4.1-mini,8353,176,8529
2025-08-15T04:35:12Z,pre_sentiment,gpt-4.1-mini,299,1,300
2025-08-15T04:35:14Z,sentiment,gpt-4.1-mini,1554,163,1717
2025-08-15T04:35:14Z,pre_sentiment,gpt-4.1-mini,281,1,282
2025-08-15T04:35:16Z,sentiment,gpt-4.1-mini,1324,163,1487
2025-08-15T04:35:17Z,pre_sentiment,gpt-4.1-mini,287,1,288
2025-08-15T04:35:19Z,sentiment,gpt-4.1-mini,1407,183,1590
2025-08-15T04:35:19Z,pre_sentiment,gpt-4.1-mini,295,1,296
2025-08-15T04:35:21Z,sentiment,gpt-4.1-mini,2857,162,3019
2025-08-15T04:35:22Z,pre_sentiment,gpt-4.1-mini,281,1,282
2025-08-15T04:35:24Z,sentiment,gpt-4.1-mini,1369,214,1583
2025-08-15T04:35:24Z,pre_sentiment,gpt-4.1-mini,285,1,286
2025-08-15T04:35:27Z,sentiment,gpt-4.1-mini,2517,222,2739
2025-08-15T04:35:27Z,pre_sentiment,gpt-4.1-mini,287,1,288
2025-08-15T04:35:29Z,sentiment,gpt-4.1-mini,1485,130,1615
2025-08-15T04:35:29Z,pre_sentiment,gpt-4.1-mini,270,1,271
2025-08-15T04:35:31Z,sentiment,gpt-4.1-mini,1094,127,1221
2025-08-15T04:35:31Z,pre_sentiment,gpt-4.1-mini,279,1,280
2025-08-15T04:35:34Z,sentiment,gpt-4.1-mini,3237,185,3422
2025-08-15T04:35:35Z,pre_sentiment,gpt-4.1-mini,284,1,285
2025-08-15T04:35:38Z,sentiment,gpt-4.1-mini,1327,245,1572
2025-08-15T04:35:43Z,pre_sentiment,gpt-4.1-mini,287,1,288
2025-08-15T04:35:45Z,sentiment,gpt-4.1-mini,3980,207,4187
2025-08-15T04:35:46Z,pre_sentiment,gpt-4.1-mini,292,1,293
2025-08-15T04:36:05Z,pre_sentiment,gpt-4.1-mini,291,1,292
2025-08-15T04:36:07Z,sentiment,gpt-4.1-mini,2494,208,2702
2025-08-15T04:36:07Z,pre_sentiment,gpt-4.1-mini,262,1,263
2025-08-15T04:36:09Z,sentiment,gpt-4.1-mini,2003,177,2180
2025-08-15T04:36:10Z,pre_sentiment,gpt-4.1-mini,265,1,266
2025-08-15T04:36:12Z,sentiment,gpt-4.1-mini,2390,244,2634
2025-08-15T04:36:17Z,pre_sentiment,gpt-4.1-mini,275,1,276
2025-08-15T04:36:19Z,sentiment,gpt-4.1-mini,3695,234,3929
2025-08-15T04:36:20Z,pre_sentiment,gpt-4.1-mini,279,1,280
2025-08-15T04:36:20Z,pre_sentiment,gpt-4.1-mini,278,1,279
2025-08-15T04:36:20Z,pre_sentiment,gpt-4.1-mini,283,1,284
2025-08-15T04:36:29Z,pre_sentiment,gpt-4.1-mini,284,1,285
2025-08-15T04:36:31Z,sentiment,gpt-4.1-mini,1581,166,1747
2025-08-15T04:36:31Z,pre_sentiment,gpt-4.1-mini,285,1,286
2025-08-15T04:36:34Z,sentiment,gpt-4.1-mini,1466,197,1663
2025-08-15T04:36:34Z,pre_sentiment,gpt-4.1-mini,286,1,287
2025-08-15T04:36:37Z,sentiment,gpt-4.1-mini,1728,196,1924
2025-08-15T04:36:37Z,pre_sentiment,gpt-4.1-mini,280,1,281
2025-08-15T04:36:41Z,sentiment,gpt-4.1-mini,1640,208,1848
2025-08-15T04:36:41Z,pre_sentiment,gpt-4.1-mini,283,1,284
2025-08-15T04:36:43Z,sentiment,gpt-4.1-mini,2799,171,2970
2025-08-15T04:36:44Z,pre_sentiment,gpt-4.1-mini,286,1,287
2025-08-15T04:36:44Z,pre_sentiment,gpt-4.1-mini,284,1,285
2025-08-15T04:36:46Z,sentiment,gpt-4.1-mini,1558,184,1742
2025-08-15T04:36:54Z,pre_sentiment,gpt-4.1-mini,280,1,281
2025-08-15T04:36:56Z,sentiment,gpt-4.1-mini,1812,140,1952
2025-08-15T04:36:56Z,pre_sentiment,gpt-4.1-mini,286,1,287
2025-08-15T04:36:56Z,pre_sentiment,gpt-4.1-mini,290,1,291
2025-08-15T04:36:57Z,pre_sentiment,gpt-4.1-mini,280,1,281
2025-08-15T04:36:59Z,sentiment,gpt-4.1-mini,1852,187,2039
2025-08-15T04:36:59Z,pre_sentiment,gpt-4.1-mini,281,1,282
2025-08-15T04:37:17Z,pre_sentiment,gpt-4.1-mini,280,1,281
2025-08-15T04:37:19Z,sentiment,gpt-4.1-mini,1812,146,1958
2025-08-15T04:37:19Z,pre_sentiment,gpt-4.1-mini,286,1,287
2025-08-15T04:37:20Z,pre_sentiment,gpt-4.1-mini,290,1,291
2025-08-15T04:37:21Z,pre_sentiment,gpt-4.1-mini,281,1,282
2025-08-15T04:37:43Z,pre_sentiment,gpt-4.1-mini,290,1,291
2025-08-15T04:37:45Z,sentiment,gpt-4.1-mini,1692,164,1856
2025-08-15T04:37:46Z,pre_sentiment,gpt-4.1-mini,287,1,288
2025-08-15T04:37:49Z,sentiment,gpt-4.1-mini,1721,187,1908
2025-08-15T04:37:49Z,pre_sentiment,gpt-4.1-mini,289,1,290
2025-08-15T04:37:50Z,sentiment,gpt-4.1-mini,1589,157,1746
2025-08-15T04:38:04Z,pre_sentiment,gpt-4.1-mini,296,1,297
2025-08-15T04:38:04Z,pre_sentiment,gpt-4.1-mini,303,1,304
2025-08-15T04:38:07Z,sentiment,gpt-4.1-mini,1938,211,2149
2025-08-15T04:38:07Z,pre_sentiment,gpt-4.1-mini,279,1,280
2025-08-15T04:38:07Z,pre_sentiment,gpt-4.1-mini,286,1,287
2025-08-15T04:38:07Z,pre_sentiment,gpt-4.1-mini,282,1,283
2025-08-15T04:38:18Z,pre_sentiment,gpt-4.1-mini,288,1,289
2025-08-15T04:38:19Z,pre_sentiment,gpt-4.1-mini,282,1,283
2025-08-15T04:38:20Z,sentiment,gpt-4.1-mini,1892,202,2094
2025-08-15T04:38:21Z,pre_sentiment,gpt-4.1-mini,283,1,284
2025-08-15T04:38:23Z,sentiment,gpt-4.1-mini,3697,245,3942
2025-08-15T04:38:23Z,pre_sentiment,gpt-4.1-mini,284,1,285
2025-08-15T04:38:25Z,sentiment,gpt-4.1-mini,2604,200,2804
2025-08-15T04:38:36Z,pre_sentiment,gpt-4.1-mini,288,1,289
2025-08-15T04:38:39Z,sentiment,gpt-4.1-mini,1149,191,1340
2025-08-15T04:38:40Z,pre_sentiment,gpt-4.1-mini,292,1,293
2025-08-15T04:38:42Z,pre_sentiment,gpt-4.1-mini,281,1,282
2025-08-15T04:38:43Z,pre_sentiment,gpt-4.1-mini,291,1,292
2025-08-15T04:38:43Z,pre_sentiment,gpt-4.1-mini,295,1,296
2025-08-15T04:38:45Z,sentiment,gpt-4.1-mini,1507,181,1688
2025-08-15T04:38:45Z,pre_sentiment,gpt-4.1-mini,290,1,291
2025-08-15T04:38:46Z,pre_sentiment,gpt-4.1-mini,282,1,283
2025-08-15T04:38:46Z,pre_sentiment,gpt-4.1-mini,292,1,293
2025-08-15T04:38:48Z,sentiment,gpt-4.1-mini,1248,186,1434
2025-08-15T04:38:48Z,pre_sentiment,gpt-4.1-mini,295,1,296
2025-08-15T04:38:49Z,pre_sentiment,gpt-4.1-mini,282,1,283
2025-08-15T04:38:49Z,pre_sentiment,gpt-4.1-mini,294,1,295
2025-08-15T04:38:49Z,pre_sentiment,gpt-4.1-mini,280,1,281
2025-08-15T04:38:49Z,pre_sentiment,gpt-4.1-mini,282,1,283
2025-08-15T04:38:55Z,pre_sentiment,gpt-4.1-mini,298,1,299
2025-08-15T04:38:57Z,sentiment,gpt-4.1-mini,5081,240,5321
2025-08-15T04:38:59Z,article_selection,gpt-4.1-mini,1838,12,1850
2025-08-15T04:39:00Z,article_selection,gpt-4.1-mini,1453,9,1462
2025-08-15T04:39:00Z,article_selection,gpt-4.1-mini,3284,12,3296
2025-08-15T04:39:01Z,article_selection,gpt-4.1-mini,1127,12,1139
2025-08-15T04:39:01Z,article_selection,gpt-4.1-mini,2518,16,2534
2025-08-15T04:39:14Z,final_summary_en,gpt-4.1-mini,1201,1012,2213
2025-08-15T04:39:25Z,final_summary_en,gpt-4.1-mini,1263,1123,2386
2025-08-15T04:39:40Z,final_summary_en,gpt-4.1-mini,1714,1362,3076
2025-08-15T04:39:52Z,final_summary_en,gpt-4.1-mini,1402,1014,2416
2025-08-15T04:40:16Z,final_summary_en,gpt-4.1-mini,2246,1500,3746
2025-08-15T04:40:35Z,final_summary_en,gpt-4.1-mini,1172,1282,2454
2025-08-15T04:40:47Z,final_summary_en,gpt-4.1-mini,3742,1070,4812
2025-08-15T04:41:12Z,final_summary_en,gpt-4.1-mini,2149,1428,3577
2025-08-15T04:41:24Z,final_summary_en,gpt-4.1-mini,4841,1385,6226
2025-08-15T04:41:41Z,final_summary_en,gpt-4.1-mini,1991,1369,3360
2025-08-15T04:41:52Z,final_summary_en,gpt-4.1-mini,1140,1205,2345
2025-08-15T04:42:06Z,final_summary_en,gpt-4.1-mini,1129,1182,2311
2025-08-15T04:42:20Z,final_summary_en,gpt-4.1-mini,1304,1133,2437
2025-08-15T04:42:33Z,final_summary_en,gpt-4.1-mini,1111,1075,2186
2025-08-15T04:42:47Z,final_summary_en,gpt-4.1-mini,1321,1254,2575
2025-08-15T04:42:59Z,final_summary_en,gpt-4.1-mini,1210,1107,2317
2025-08-15T04:43:09Z,final_summary_en,gpt-4.1-mini,1697,924,2621
2025-08-15T04:43:26Z,final_summary_en,gpt-4.1-mini,3467,1471,4938
2025-08-15T04:43:39Z,final_summary_en,gpt-4.1-mini,1749,1237,2986
2025-08-15T04:43:50Z,final_summary_en,gpt-4.1-mini,988,977,1965
2025-08-15T04:44:55Z,category_summary,gpt-4.1-mini,137,31,168
2025-08-15T04:44:57Z,category_summary,gpt-4.1-mini,135,35,170
2025-08-15T04:44:58Z,category_summary,gpt-4.1-mini,113,28,141
2025-08-15T04:45:03Z,category_summary,gpt-4.1-mini,145,42,187
2025-08-15T04:45:05Z,category_summary,gpt-4.1-mini,130,33,163
2025-08-15T04:45:06Z,RUN_TOTAL,,198031,35439,233470
2025-08-16T04:28:23Z,pre_sentiment,gpt-4.1-mini,287,1,288
2025-08-16T04:28:23Z,pre_sentiment,gpt-4.1-mini,289,1,290
2025-08-16T04:28:24Z,pre_sentiment,gpt-4.1-mini,281,1,282
2025-08-16T04:28:25Z,pre_sentiment,gpt-4.1-mini,286,1,287
2025-08-16T04:28:28Z,sentiment,gpt-4.1-mini,2165,178,2343
2025-08-16T04:28:28Z,pre_sentiment,gpt-4.1-mini,286,1,287
2025-08-16T04:28:34Z,sentiment,gpt-4.1-mini,2248,170,2418
2025-08-16T04:28:38Z,pre_sentiment,gpt-4.1-mini,286,1,287
2025-08-16T04:28:42Z,sentiment,gpt-4.1-mini,3047,208,3255
2025-08-16T04:28:43Z,pre_sentiment,gpt-4.1-mini,285,1,286
2025-08-16T04:28:43Z,pre_sentiment,gpt-4.1-mini,282,1,283
2025-08-16T04:28:44Z,pre_sentiment,gpt-4.1-mini,279,1,280
2025-08-16T04:28:46Z,sentiment,gpt-4.1-mini,1353,165,1518
2025-08-16T04:28:46Z,pre_sentiment,gpt-4.1-mini,282,1,283
2025-08-16T04:28:47Z,pre_sentiment,gpt-4.1-mini,283,1,284
2025-08-16T04:28:54Z,pre_sentiment,gpt-4.1-mini,278,1,279
2025-08-16T04:28:55Z,sentiment,gpt-4.1-mini,1124,116,1240
2025-08-16T04:28:56Z,pre_sentiment,gpt-4.1-mini,285,1,286
2025-08-16T04:28:56Z,pre_sentiment,gpt-4.1-mini,285,1,286
2025-08-16T04:28:58Z,sentiment,gpt-4.1-mini,1911,161,2072
2025-08-16T04:28:58Z,pre_sentiment,gpt-4.1-mini,281,1,282
2025-08-16T04:28:58Z,pre_sentiment,gpt-4.1-mini,279,1,280
2025-08-16T04:29:08Z,pre_sentiment,gpt-4.1-mini,281,1,282
2025-08-16T04:29:14Z,pre_sentiment,gpt-4.1-mini,289,1,290
2025-08-16T04:29:17Z,sentiment,gpt-4.1-mini,1803,189,1992
2025-08-16T04:29:17Z,pre_sentiment,gpt-4.1-mini,278,1,279
2025-08-16T04:29:20Z,sentiment,gpt-4.1-mini,1381,185,1566
2025-08-16T04:29:20Z,pre_sentiment,gpt-4.1-mini,282,1,283
2025-08-16T04:29:24Z,sentiment,gpt-4.1-mini,2302,223,2525
2025-08-16T04:29:24Z,pre_sentiment,gpt-4.1-mini,284,1,285
2025-08-16T04:29:27Z,sentiment,gpt-4.1-mini,1476,192,1668
2025-08-16T04:29:27Z,pre_sentiment,gpt-4.1-mini,282,1,283
2025-08-16T04:29:30Z,sentiment,gpt-4.1-mini,1389,222,1611
2025-08-16T04:29:30Z,pre_sentiment,gpt-4.1-mini,279,1,280
2025-08-16T04:29:32Z,sentiment,gpt-4.1-mini,1466,164,1630
2025-08-16T04:29:32Z,pre_sentiment,gpt-4.1-mini,280,1,281
2025-08-16T04:29:37Z,sentiment,gpt-4.1-mini,1793,191,1984
2025-08-16T04:29:37Z,pre_sentiment,gpt-4.1-mini,287,1,288
2025-08-16T04:29:39Z,sentiment,gpt-4.1-mini,1191,173,1364
2025-08-16T04:29:39Z,pre_sentiment,gpt-4.1-mini,283,1,284
2025-08-16T04:29:42Z,sentiment,gpt-4.1-mini,2036,185,2221
2025-08-16T04:29:55Z,pre_sentiment,gpt-4.1-mini,300,1,301
2025-08-16T04:29:57Z,sentiment,gpt-4.1-mini,1027,108,1135
2025-08-16T04:29:57Z,pre_sentiment,gpt-4.1-mini,296,1,297
2025-08-16T04:29:58Z,sentiment,gpt-4.1-mini,917,94,1011
2025-08-16T04:29:58Z,pre_sentiment,gpt-4.1-mini,287,1,288
2025-08-16T04:30:00Z,sentiment,gpt-4.1-mini,1769,113,1882
2025-08-16T04:30:01Z,pre_sentiment,gpt-4.1-mini,297,1,298
2025-08-16T04:30:03Z,sentiment,gpt-4.1-mini,1592,201,1793
2025-08-16T04:30:04Z,pre_sentiment,gpt-4.1-mini,297,1,298
2025-08-16T04:30:05Z,sentiment,gpt-4.1-mini,1979,201,2180
2025-08-16T04:30:06Z,pre_sentiment,gpt-4.1-mini,296,1,297
2025-08-16T04:30:07Z,sentiment,gpt-4.1-mini,1293,176,1469
2025-08-16T04:30:07Z,pre_sentiment,gpt-4.1-mini,297,1,298
2025-08-16T04:30:09Z,sentiment,gpt-4.1-mini,919,115,1034
2025-08-16T04:30:09Z,pre_sentiment,gpt-4.1-mini,300,1,301
2025-08-16T04:30:09Z,pre_sentiment,gpt-4.1-mini,298,1,299
2025-08-16T04:30:12Z,sentiment,gpt-4.1-mini,1738,157,1895
2025-08-16T04:30:12Z,pre_sentiment,gpt-4.1-mini,296,1,297
2025-08-16T04:30:15Z,sentiment,gpt-4.1-mini,1481,224,1705
2025-08-16T04:30:15Z,pre_sentiment,gpt-4.1-mini,300,1,301
2025-08-16T04:30:17Z,sentiment,gpt-4.1-mini,2029,147,2176
2025-08-16T04:30:17Z,pre_sentiment,gpt-4.1-mini,296,1,297
2025-08-16T04:30:17Z,pre_sentiment,gpt-4.1-mini,298,1,299
2025-08-16T04:30:18Z,sentiment,gpt-4.1-mini,914,87,1001
2025-08-16T04:30:19Z,pre_sentiment,gpt-4.1-mini,293,1,294
2025-08-16T04:30:20Z,sentiment,gpt-4.1-mini,901,94,995
2025-08-16T04:30:37Z,pre_sentiment,gpt-4.1-mini,282,1,283
2025-08-16T04:30:40Z,sentiment,gpt-4.1-mini,1454,213,1667
2025-08-16T04:30:40Z,pre_sentiment,gpt-4.1-mini,279,1,280
2025-08-16T04:30:42Z,sentiment,gpt-4.1-mini,1419,163,1582
2025-08-16T04:30:43Z,pre_sentiment,gpt-4.1-mini,283,1,284
2025-08-16T04:30:45Z,sentiment,gpt-4.1-mini,1293,143,1436
2025-08-16T04:30:45Z,pre_sentiment,gpt-4.1-mini,277,1,278
2025-08-16T04:30:47Z,sentiment,gpt-4.1-mini,1398,182,1580
2025-08-16T04:30:47Z,pre_sentiment,gpt-4.1-mini,276,1,277
2025-08-16T04:30:49Z,sentiment,gpt-4.1-mini,1054,129,1183
2025-08-16T04:30:49Z,pre_sentiment,gpt-4.1-mini,286,1,287
2025-08-16T04:30:52Z,sentiment,gpt-4.1-mini,1453,176,1629
2025-08-16T04:30:52Z,pre_sentiment,gpt-4.1-mini,289,1,290
2025-08-16T04:30:54Z,sentiment,gpt-4.1-mini,1255,167,1422
2025-08-16T04:30:54Z,pre_sentiment,gpt-4.1-mini,282,1,283
2025-08-16T04:30:56Z,sentiment,gpt-4.1-mini,1547,171,1718
2025-08-16T04:30:57Z,pre_sentiment,gpt-4.1-mini,299,1,300
2025-08-16T04:30:58Z,sentiment,gpt-4.1-mini,1554,155,1709
2025-08-16T04:31:02Z,pre_sentiment,gpt-4.1-mini,281,1,282
2025-08-16T04:31:04Z,sentiment,gpt-4.1-mini,946,125,1071
2025-08-16T04:31:23Z,pre_sentiment,gpt-4.1-mini,262,1,263
2025-08-16T04:31:23Z,pre_sentiment,gpt-4.1-mini,265,1,266
2025-08-16T04:31:23Z,pre_sentiment,gpt-4.1-mini,289,1,290
2025-08-16T04:31:23Z,pre_sentiment,gpt-4.1-mini,266,1,267
2025-08-16T04:31:24Z,pre_sentiment,gpt-4.1-mini,267,1,268
2025-08-16T04:31:28Z,pre_sentiment,gpt-4.1-mini,276,1,277
2025-08-16T04:31:28Z,pre_sentiment,gpt-4.1-mini,281,1,282
2025-08-16T04:31:28Z,pre_sentiment,gpt-4.1-mini,275,1,276
2025-08-16T04:31:30Z,sentiment,gpt-4.1-mini,3695,233,3928
2025-08-16T04:31:36Z,pre_sentiment,gpt-4.1-mini,275,1,276
2025-08-16T04:31:37Z,pre_sentiment,gpt-4.1-mini,281,1,282
2025-08-16T04:31:42Z,sentiment,gpt-4.1-mini,2071,183,2254
2025-08-16T04:31:42Z,pre_sentiment,gpt-4.1-mini,286,1,287
2025-08-16T04:31:44Z,sentiment,gpt-4.1-mini,1491,182,1673
2025-08-16T04:31:44Z,pre_sentiment,gpt-4.1-mini,278,1,279
2025-08-16T04:31:46Z,sentiment,gpt-4.1-mini,1446,175,1621
2025-08-16T04:31:47Z,pre_sentiment,gpt-4.1-mini,279,1,280
2025-08-16T04:31:49Z,sentiment,gpt-4.1-mini,1456,141,1597
2025-08-16T04:31:49Z,pre_sentiment,gpt-4.1-mini,281,1,282
2025-08-16T04:31:51Z,sentiment,gpt-4.1-mini,1530,180,1710
2025-08-16T04:31:58Z,pre_sentiment,gpt-4.1-mini,284,1,285
2025-08-16T04:31:59Z,pre_sentiment,gpt-4.1-mini,283,1,284
2025-08-16T04:31:59Z,pre_sentiment,gpt-4.1-mini,284,1,285
2025-08-16T04:32:13Z,pre_sentiment,gpt-4.1-mini,284,1,285
2025-08-16T04:32:14Z,pre_sentiment,gpt-4.1-mini,283,1,284
2025-08-16T04:32:14Z,pre_sentiment,gpt-4.1-mini,284,1,285
2025-08-16T04:32:31Z,pre_sentiment,gpt-4.1-mini,288,1,289
2025-08-16T04:32:34Z,sentiment,gpt-4.1-mini,1467,195,1662
2025-08-16T04:32:34Z,pre_sentiment,gpt-4.1-mini,294,1,295
2025-08-16T04:32:37Z,sentiment,gpt-4.1-mini,5339,218,5557
2025-08-16T04:32:38Z,pre_sentiment,gpt-4.1-mini,290,1,291
2025-08-16T04:32:40Z,sentiment,gpt-4.1-mini,1692,165,1857
2025-08-16T04:32:53Z,pre_sentiment,gpt-4.1-mini,285,1,286
2025-08-16T04:32:55Z,sentiment,gpt-4.1-mini,2152,220,2372
2025-08-16T04:32:55Z,pre_sentiment,gpt-4.1-mini,282,1,283
2025-08-16T04:32:56Z,pre_sentiment,gpt-4.1-mini,297,1,298
2025-08-16T04:32:56Z,pre_sentiment,gpt-4.1-mini,282,1,283
2025-08-16T04:32:57Z,pre_sentiment,gpt-4.1-mini,284,1,285
2025-08-16T04:32:57Z,pre_sentiment,gpt-4.1-mini,289,1,290
2025-08-16T04:32:59Z,sentiment,gpt-4.1-mini,1646,211,1857
2025-08-16T04:33:12Z,pre_sentiment,gpt-4.1-mini,285,1,286
2025-08-16T04:33:13Z,pre_sentiment,gpt-4.1-mini,284,1,285
2025-08-16T04:33:15Z,sentiment,gpt-4.1-mini,1861,187,2048
2025-08-16T04:33:15Z,pre_sentiment,gpt-4.1-mini,285,1,286
2025-08-16T04:33:17Z,sentiment,gpt-4.1-mini,3366,233,3599
2025-08-16T04:33:17Z,pre_sentiment,gpt-4.1-mini,288,1,289
2025-08-16T04:33:29Z,pre_sentiment,gpt-4.1-mini,282,1,283
2025-08-16T04:33:30Z,sentiment,gpt-4.1-mini,1075,159,1234
2025-08-16T04:33:30Z,pre_sentiment,gpt-4.1-mini,286,1,287
2025-08-16T04:33:32Z,sentiment,gpt-4.1-mini,1131,184,1315
2025-08-16T04:33:32Z,pre_sentiment,gpt-4.1-mini,293,1,294
2025-08-16T04:33:33Z,pre_sentiment,gpt-4.1-mini,296,1,297
2025-08-16T04:33:35Z,sentiment,gpt-4.1-mini,1102,200,1302
2025-08-16T04:33:35Z,pre_sentiment,gpt-4.1-mini,288,1,289
2025-08-16T04:33:36Z,sentiment,gpt-4.1-mini,1182,160,1342
2025-08-16T04:33:43Z,article_selection,gpt-4.1-mini,1431,9,1440
2025-08-16T04:33:44Z,article_selection,gpt-4.1-mini,785,16,801
2025-08-16T04:33:44Z,article_selection,gpt-4.1-mini,486,5,491
2025-08-16T04:33:44Z,article_selection,gpt-4.1-mini,1249,12,1261
2025-08-16T04:33:45Z,article_selection,gpt-4.1-mini,1087,9,1096
2025-08-16T04:33:45Z,article_selection,gpt-4.1-mini,2249,16,2265
2025-08-16T04:33:57Z,final_summary_en,gpt-4.1-mini,2061,1311,3372
2025-08-16T04:34:13Z,final_summary_en,gpt-4.1-mini,1240,1060,2300
2025-08-16T04:34:23Z,final_summary_en,gpt-4.1-mini,1261,939,2200
2025-08-16T04:34:40Z,final_summary_en,gpt-4.1-mini,5106,1595,6701
2025-08-16T04:34:55Z,final_summary_en,gpt-4.1-mini,1619,1182,2801
2025-08-16T04:35:08Z,final_summary_en,gpt-4.1-mini,3130,1248,4378
2025-08-16T04:35:24Z,final_summary_en,gpt-4.1-mini,1548,1020,2568
2025-08-16T04:35:32Z,final_summary_en,gpt-4.1-mini,872,1086,1958
2025-08-16T04:35:47Z,final_summary_en,gpt-4.1-mini,1213,1216,2429
2025-08-16T04:36:05Z,final_summary_en,gpt-4.1-mini,847,1149,1996
2025-08-16T04:36:17Z,final_summary_en,gpt-4.1-mini,1550,1339,2889
2025-08-16T04:36:26Z,final_summary_en,gpt-4.1-mini,1140,952,2092
2025-08-16T04:36:38Z,final_summary_en,gpt-4.1-mini,1217,1236,2453
2025-08-16T04:36:52Z,final_summary_en,gpt-4.1-mini,929,1180,2109
2025-08-16T04:37:06Z,final_summary_en,gpt-4.1-mini,1131,1088,2219
2025-08-16T04:37:18Z,final_summary_en,gpt-4.1-mini,1200,1018,2218
2025-08-16T04:37:34Z,final_summary_en,gpt-4.1-mini,1222,1030,2252
2025-08-16T04:37:50Z,final_summary_en,gpt-4.1-mini,1812,1318,3130
2025-08-16T04:38:03Z,final_summary_en,gpt-4.1-mini,1910,1066,2976
2025-08-16T04:38:21Z,final_summary_en,gpt-4.1-mini,1896,1382,3278
2025-08-16T04:38:42Z,final_summary_en,gpt-4.1-mini,3466,1319,4785
2025-08-16T04:39:01Z,final_summary_en,gpt-4.1-mini,2811,1404,4215
2025-08-16T04:40:29Z,category_summary,gpt-4.1-mini,137,35,172
2025-08-16T04:40:32Z,category_summary,gpt-4.1-mini,126,38,164
2025-08-16T04:40:33Z,category_summary,gpt-4.1-mini,116,39,155
2025-08-16T04:40:35Z,category_summary,gpt-4.1-mini,129,27,156
2025-08-16T04:40:37Z,category_summary,gpt-4.1-mini,128,54,182
2025-08-16T04:40:39Z,category_summary,gpt-4.1-mini,113,33,146
2025-08-16T04:40:40Z,RUN_TOTAL,,162621,35808,198429
2025-08-17T04:34:48Z,pre_sentiment,gpt-4.1-mini,293,1,294
2025-08-17T04:34:49Z,pre_sentiment,gpt-4.1-mini,286,1,287
2025-08-17T04:34:49Z,pre_sentiment,gpt-4.1-mini,283,1,284
2025-08-17T04:34:49Z,pre_sentiment,gpt-4.1-mini,288,1,289
2025-08-17T04:34:50Z,pre_sentiment,gpt-4.1-mini,282,1,283
2025-08-17T04:34:51Z,sentiment,gpt-4.1-mini,1594,108,1702
2025-08-17T04:34:52Z,pre_sentiment,gpt-4.1-mini,280,1,281
2025-08-17T04:34:52Z,pre_sentiment,gpt-4.1-mini,280,1,281
2025-08-17T04:34:53Z,pre_sentiment,gpt-4.1-mini,291,1,292
2025-08-17T04:34:53Z,pre_sentiment,gpt-4.1-mini,282,1,283
2025-08-17T04:34:54Z,pre_sentiment,gpt-4.1-mini,284,1,285
2025-08-17T04:34:57Z,sentiment,gpt-4.1-mini,1818,161,1979
2025-08-17T04:34:57Z,pre_sentiment,gpt-4.1-mini,288,1,289
2025-08-17T04:34:59Z,sentiment,gpt-4.1-mini,1744,190,1934
2025-08-17T04:34:59Z,pre_sentiment,gpt-4.1-mini,289,1,290
2025-08-17T04:35:00Z,pre_sentiment,gpt-4.1-mini,285,1,286
2025-08-17T04:35:00Z,pre_sentiment,gpt-4.1-mini,282,1,283
2025-08-17T04:35:02Z,sentiment,gpt-4.1-mini,1857,139,1996
2025-08-17T04:35:19Z,pre_sentiment,gpt-4.1-mini,278,1,279
2025-08-17T04:35:21Z,sentiment,gpt-4.1-mini,1347,185,1532
2025-08-17T04:35:21Z,pre_sentiment,gpt-4.1-mini,276,1,277
2025-08-17T04:35:24Z,sentiment,gpt-4.1-mini,1690,206,1896
2025-08-17T04:35:24Z,pre_sentiment,gpt-4.1-mini,284,1,285
2025-08-17T04:35:26Z,sentiment,gpt-4.1-mini,3352,152,3504
2025-08-17T04:35:26Z,pre_sentiment,gpt-4.1-mini,283,1,284
2025-08-17T04:35:27Z,pre_sentiment,gpt-4.1-mini,281,1,282
2025-08-17T04:35:30Z,sentiment,gpt-4.1-mini,1689,178,1867
2025-08-17T04:35:30Z,pre_sentiment,gpt-4.1-mini,279,1,280
2025-08-17T04:35:33Z,sentiment,gpt-4.1-mini,1924,212,2136
2025-08-17T04:35:33Z,pre_sentiment,gpt-4.1-mini,284,1,285
2025-08-17T04:35:46Z,pre_sentiment,gpt-4.1-mini,300,1,301
2025-08-17T04:35:51Z,sentiment,gpt-4.1-mini,1027,131,1158
2025-08-17T04:35:51Z,pre_sentiment,gpt-4.1-mini,296,1,297
2025-08-17T04:35:53Z,sentiment,gpt-4.1-mini,917,113,1030
2025-08-17T04:35:53Z,pre_sentiment,gpt-4.1-mini,287,1,288
2025-08-17T04:35:54Z,sentiment,gpt-4.1-mini,1769,115,1884
2025-08-17T04:35:54Z,pre_sentiment,gpt-4.1-mini,297,1,298
2025-08-17T04:35:57Z,sentiment,gpt-4.1-mini,1592,211,1803
2025-08-17T04:35:57Z,pre_sentiment,gpt-4.1-mini,297,1,298
2025-08-17T04:36:00Z,sentiment,gpt-4.1-mini,1979,183,2162
2025-08-17T04:36:00Z,pre_sentiment,gpt-4.1-mini,296,1,297
2025-08-17T04:36:04Z,sentiment,gpt-4.1-mini,1293,178,1471
2025-08-17T04:36:04Z,pre_sentiment,gpt-4.1-mini,297,1,298
2025-08-17T04:36:06Z,sentiment,gpt-4.1-mini,919,125,1044
2025-08-17T04:36:06Z,pre_sentiment,gpt-4.1-mini,300,1,301
2025-08-17T04:36:07Z,pre_sentiment,gpt-4.1-mini,298,1,299
2025-08-17T04:36:09Z,sentiment,gpt-4.1-mini,1738,174,1912
2025-08-17T04:36:09Z,pre_sentiment,gpt-4.1-mini,300,1,301
2025-08-17T04:36:12Z,sentiment,gpt-4.1-mini,2029,126,2155
2025-08-17T04:36:12Z,pre_sentiment,gpt-4.1-mini,296,1,297
2025-08-17T04:36:13Z,pre_sentiment,gpt-4.1-mini,298,1,299
2025-08-17T04:36:14Z,sentiment,gpt-4.1-mini,914,77,991
2025-08-17T04:36:14Z,pre_sentiment,gpt-4.1-mini,293,1,294
2025-08-17T04:36:15Z,sentiment,gpt-4.1-mini,901,91,992
2025-08-17T04:36:40Z,pre_sentiment,gpt-4.1-mini,269,1,270
2025-08-17T04:36:53Z,pre_sentiment,gpt-4.1-mini,282,1,283
2025-08-17T04:37:00Z,pre_sentiment,gpt-4.1-mini,282,1,283
2025-08-17T04:37:42Z,pre_sentiment,gpt-4.1-mini,293,1,294
2025-08-17T04:37:43Z,pre_sentiment,gpt-4.1-mini,291,1,292
2025-08-17T04:37:43Z,pre_sentiment,gpt-4.1-mini,285,1,286
2025-08-17T04:37:43Z,pre_sentiment,gpt-4.1-mini,285,1,286
2025-08-17T04:37:55Z,pre_sentiment,gpt-4.1-mini,286,1,287
2025-08-17T04:38:03Z,article_selection,gpt-4.1-mini,850,12,862
2025-08-17T04:38:03Z,article_selection,gpt-4.1-mini,545,13,558
2025-08-17T04:38:04Z,article_selection,gpt-4.1-mini,371,6,377
2025-08-17T04:38:15Z,final_summary_en,gpt-4.1-mini,1458,951,2409
2025-08-17T04:38:31Z,final_summary_en,gpt-4.1-mini,1425,1166,2591
2025-08-17T04:38:43Z,final_summary_en,gpt-4.1-mini,1354,978,2332
2025-08-17T04:38:57Z,final_summary_en,gpt-4.1-mini,1476,923,2399
2025-08-17T04:39:12Z,final_summary_en,gpt-4.1-mini,1674,1202,2876
2025-08-17T04:39:24Z,final_summary_en,gpt-4.1-mini,1040,983,2023
2025-08-17T04:39:46Z,final_summary_en,gpt-4.1-mini,1722,1168,2890
2025-08-17T04:40:06Z,final_summary_en,gpt-4.1-mini,1496,1220,2716
2025-08-17T04:40:25Z,final_summary_en,gpt-4.1-mini,1571,911,2482
2025-08-17T04:41:16Z,category_summary,gpt-4.1-mini,108,34,142
2025-08-17T04:41:18Z,category_summary,gpt-4.1-mini,123,28,151
2025-08-17T04:41:20Z,category_summary,gpt-4.1-mini,108,21,129
2025-08-17T04:41:20Z,RUN_TOTAL,,59500,12713,72213
2025-08-18T04:40:59Z,pre_sentiment,gpt-4.1-mini,287,1,288
2025-08-18T04:41:00Z,pre_sentiment,gpt-4.1-mini,288,1,289
2025-08-18T04:41:02Z,sentiment,gpt-4.1-mini,1440,138,1578
2025-08-18T04:41:03Z,pre_sentiment,gpt-4.1-mini,296,1,297
2025-08-18T04:41:03Z,pre_sentiment,gpt-4.1-mini,288,1,289
2025-08-18T04:41:04Z,sentiment,gpt-4.1-mini,1252,133,1385
2025-08-18T04:41:04Z,pre_sentiment,gpt-4.1-mini,285,1,286
2025-08-18T04:41:05Z,pre_sentiment,gpt-4.1-mini,292,1,293
2025-08-18T04:41:05Z,pre_sentiment,gpt-4.1-mini,284,1,285
2025-08-18T04:41:06Z,pre_sentiment,gpt-4.1-mini,284,1,285
2025-08-18T04:41:07Z,pre_sentiment,gpt-4.1-mini,278,1,279
2025-08-18T04:41:08Z,pre_sentiment,gpt-4.1-mini,276,1,277
2025-08-18T04:41:08Z,pre_sentiment,gpt-4.1-mini,291,1,292
2025-08-18T04:41:09Z,pre_sentiment,gpt-4.1-mini,286,1,287
2025-08-18T04:41:09Z,pre_sentiment,gpt-4.1-mini,282,1,283
2025-08-18T04:41:09Z,pre_sentiment,gpt-4.1-mini,284,1,285
2025-08-18T04:41:12Z,sentiment,gpt-4.1-mini,2583,236,2819
2025-08-18T04:41:12Z,pre_sentiment,gpt-4.1-mini,291,1,292
2025-08-18T04:41:21Z,pre_sentiment,gpt-4.1-mini,283,1,284
2025-08-18T04:41:32Z,pre_sentiment,gpt-4.1-mini,277,1,278
2025-08-18T04:41:35Z,sentiment,gpt-4.1-mini,1922,192,2114
2025-08-18T04:41:35Z,pre_sentiment,gpt-4.1-mini,286,1,287
2025-08-18T04:41:38Z,sentiment,gpt-4.1-mini,1449,210,1659
2025-08-18T04:41:38Z,pre_sentiment,gpt-4.1-mini,281,1,282
2025-08-18T04:41:40Z,sentiment,gpt-4.1-mini,1595,174,1769
2025-08-18T04:41:40Z,pre_sentiment,gpt-4.1-mini,280,1,281
2025-08-18T04:41:43Z,sentiment,gpt-4.1-mini,1601,191,1792
2025-08-18T04:41:43Z,pre_sentiment,gpt-4.1-mini,278,1,279
2025-08-18T04:41:45Z,sentiment,gpt-4.1-mini,1347,189,1536
2025-08-18T04:41:45Z,pre_sentiment,gpt-4.1-mini,291,1,292
2025-08-18T04:41:48Z,sentiment,gpt-4.1-mini,1737,185,1922
2025-08-18T04:42:05Z,pre_sentiment,gpt-4.1-mini,300,1,301
2025-08-18T04:42:07Z,sentiment,gpt-4.1-mini,1027,106,1133
2025-08-18T04:42:08Z,pre_sentiment,gpt-4.1-mini,296,1,297
2025-08-18T04:42:10Z,sentiment,gpt-4.1-mini,917,109,1026
2025-08-18T04:42:10Z,pre_sentiment,gpt-4.1-mini,287,1,288
2025-08-18T04:42:12Z,sentiment,gpt-4.1-mini,1769,109,1878
2025-08-18T04:42:13Z,pre_sentiment,gpt-4.1-mini,297,1,298
2025-08-18T04:42:15Z,sentiment,gpt-4.1-mini,919,104,1023
2025-08-18T04:42:15Z,pre_sentiment,gpt-4.1-mini,300,1,301
2025-08-18T04:42:16Z,pre_sentiment,gpt-4.1-mini,300,1,301
2025-08-18T04:42:17Z,sentiment,gpt-4.1-mini,2029,161,2190
2025-08-18T04:42:18Z,pre_sentiment,gpt-4.1-mini,296,1,297
2025-08-18T04:42:18Z,pre_sentiment,gpt-4.1-mini,298,1,299
2025-08-18T04:42:19Z,sentiment,gpt-4.1-mini,914,85,999
2025-08-18T04:42:20Z,pre_sentiment,gpt-4.1-mini,293,1,294
2025-08-18T04:42:21Z,sentiment,gpt-4.1-mini,901,91,992
2025-08-18T04:42:53Z,pre_sentiment,gpt-4.1-mini,269,1,270
2025-08-18T04:42:57Z,pre_sentiment,gpt-4.1-mini,278,1,279
2025-08-18T04:43:13Z,pre_sentiment,gpt-4.1-mini,287,1,288
2025-08-18T04:43:14Z,sentiment,gpt-4.1-mini,1474,161,1635
2025-08-18T04:44:24Z,pre_sentiment,gpt-4.1-mini,285,1,286
2025-08-18T04:44:24Z,pre_sentiment,gpt-4.1-mini,283,1,284
2025-08-18T04:44:26Z,sentiment,gpt-4.1-mini,1691,173,1864
2025-08-18T04:44:26Z,pre_sentiment,gpt-4.1-mini,290,1,291
2025-08-18T04:44:28Z,sentiment,gpt-4.1-mini,2406,182,2588
2025-08-18T04:44:29Z,pre_sentiment,gpt-4.1-mini,283,1,284
2025-08-18T04:44:51Z,article_selection,gpt-4.1-mini,440,6,446
2025-08-18T04:44:52Z,article_selection,gpt-4.1-mini,509,7,516
2025-08-18T04:44:52Z,article_selection,gpt-4.1-mini,632,12,644
2025-08-18T04:45:08Z,final_summary_en,gpt-4.1-mini,1667,1049,2716
2025-08-18T04:45:21Z,final_summary_en,gpt-4.1-mini,1194,942,2136
2025-08-18T04:45:40Z,final_summary_en,gpt-4.1-mini,2356,1246,3602
2025-08-18T04:46:02Z,final_summary_en,gpt-4.1-mini,1426,1280,2706
2025-08-18T04:46:25Z,final_summary_en,gpt-4.1-mini,2157,1395,3552
2025-08-18T04:46:42Z,final_summary_en,gpt-4.1-mini,1206,1010,2216
2025-08-18T04:46:56Z,final_summary_en,gpt-4.1-mini,1336,941,2277
2025-08-18T04:47:13Z,final_summary_en,gpt-4.1-mini,1341,1149,2490
2025-08-18T04:47:31Z,final_summary_en,gpt-4.1-mini,1082,1156,2238
2025-08-18T04:47:49Z,final_summary_en,gpt-4.1-mini,1487,1142,2629
2025-08-18T04:48:27Z,category_summary,gpt-4.1-mini,99,28,127
2025-08-18T04:48:29Z,category_summary,gpt-4.1-mini,121,34,155
2025-08-18T04:48:31Z,category_summary,gpt-4.1-mini,110,39,149
2025-08-18T04:48:33Z,category_summary,gpt-4.1-mini,88,28,116
2025-08-18T04:48:34Z,RUN_TOTAL,,57134,14431,71565
2025-08-19T04:26:26Z,pre_sentiment,gpt-4.1-mini,283,1,284
2025-08-19T04:26:26Z,pre_sentiment,gpt-4.1-mini,291,1,292
2025-08-19T04:26:27Z,pre_sentiment,gpt-4.1-mini,282,1,283
2025-08-19T04:26:27Z,pre_sentiment,gpt-4.1-mini,286,1,287
2025-08-19T04:26:28Z,pre_sentiment,gpt-4.1-mini,285,1,286
2025-08-19T04:26:29Z,pre_sentiment,gpt-4.1-mini,280,1,281
2025-08-19T04:26:29Z,pre_sentiment,gpt-4.1-mini,287,1,288
2025-08-19T04:26:29Z,pre_sentiment,gpt-4.1-mini,284,1,285
2025-08-19T04:26:30Z,pre_sentiment,gpt-4.1-mini,282,1,283
2025-08-19T04:26:30Z,pre_sentiment,gpt-4.1-mini,283,1,284
2025-08-19T04:26:33Z,sentiment,gpt-4.1-mini,1784,220,2004
2025-08-19T04:26:33Z,pre_sentiment,gpt-4.1-mini,276,1,277
2025-08-19T04:26:33Z,pre_sentiment,gpt-4.1-mini,272,1,273
2025-08-19T04:26:34Z,pre_sentiment,gpt-4.1-mini,284,1,285
2025-08-19T04:26:45Z,pre_sentiment,gpt-4.1-mini,287,1,288
2025-08-19T04:26:47Z,sentiment,gpt-4.1-mini,1398,159,1557
2025-08-19T04:26:48Z,pre_sentiment,gpt-4.1-mini,281,1,282
2025-08-19T04:27:00Z,pre_sentiment,gpt-4.1-mini,285,1,286
2025-08-19T04:27:02Z,sentiment,gpt-4.1-mini,1614,193,1807
2025-08-19T04:27:03Z,pre_sentiment,gpt-4.1-mini,281,1,282
2025-08-19T04:27:09Z,pre_sentiment,gpt-4.1-mini,285,1,286
2025-08-19T04:27:16Z,sentiment,gpt-4.1-mini,2101,201,2302
2025-08-19T04:27:16Z,pre_sentiment,gpt-4.1-mini,277,1,278
2025-08-19T04:27:19Z,sentiment,gpt-4.1-mini,2138,224,2362
2025-08-19T04:27:19Z,pre_sentiment,gpt-4.1-mini,285,1,286
2025-08-19T04:27:22Z,sentiment,gpt-4.1-mini,2811,219,3030
2025-08-19T04:27:22Z,pre_sentiment,gpt-4.1-mini,282,1,283
2025-08-19T04:27:25Z,sentiment,gpt-4.1-mini,1397,183,1580
2025-08-19T04:27:25Z,pre_sentiment,gpt-4.1-mini,281,1,282
2025-08-19T04:27:41Z,pre_sentiment,gpt-4.1-mini,296,1,297
2025-08-19T04:27:42Z,sentiment,gpt-4.1-mini,908,114,1022
2025-08-19T04:27:43Z,pre_sentiment,gpt-4.1-mini,298,1,299
2025-08-19T04:27:45Z,sentiment,gpt-4.1-mini,1066,177,1243
2025-08-19T04:27:45Z,pre_sentiment,gpt-4.1-mini,294,1,295
2025-08-19T04:27:48Z,sentiment,gpt-4.1-mini,2032,205,2237
2025-08-19T04:27:48Z,pre_sentiment,gpt-4.1-mini,298,1,299
2025-08-19T04:27:51Z,sentiment,gpt-4.1-mini,1473,169,1642
2025-08-19T04:27:51Z,pre_sentiment,gpt-4.1-mini,296,1,297
2025-08-19T04:27:54Z,sentiment,gpt-4.1-mini,4148,217,4365
2025-08-19T04:27:54Z,pre_sentiment,gpt-4.1-mini,298,1,299
2025-08-19T04:27:57Z,sentiment,gpt-4.1-mini,3892,213,4105
2025-08-19T04:27:57Z,pre_sentiment,gpt-4.1-mini,298,1,299
2025-08-19T04:28:00Z,sentiment,gpt-4.1-mini,1761,175,1936
2025-08-19T04:28:00Z,pre_sentiment,gpt-4.1-mini,295,1,296
2025-08-19T04:28:03Z,sentiment,gpt-4.1-mini,2102,201,2303
2025-08-19T04:28:04Z,pre_sentiment,gpt-4.1-mini,300,1,301
2025-08-19T04:28:06Z,sentiment,gpt-4.1-mini,1027,115,1142
2025-08-19T04:28:06Z,pre_sentiment,gpt-4.1-mini,296,1,297
2025-08-19T04:28:08Z,sentiment,gpt-4.1-mini,917,119,1036
2025-08-19T04:28:08Z,pre_sentiment,gpt-4.1-mini,287,1,288
2025-08-19T04:28:10Z,sentiment,gpt-4.1-mini,1769,118,1887
2025-08-19T04:28:11Z,pre_sentiment,gpt-4.1-mini,297,1,298
2025-08-19T04:28:13Z,sentiment,gpt-4.1-mini,919,120,1039
2025-08-19T04:28:30Z,pre_sentiment,gpt-4.1-mini,288,1,289
2025-08-19T04:28:32Z,sentiment,gpt-4.1-mini,1971,188,2159
2025-08-19T04:28:33Z,pre_sentiment,gpt-4.1-mini,296,1,297
2025-08-19T04:28:35Z,sentiment,gpt-4.1-mini,2234,137,2371
2025-08-19T04:28:36Z,pre_sentiment,gpt-4.1-mini,289,1,290
2025-08-19T04:28:38Z,sentiment,gpt-4.1-mini,2627,159,2786
2025-08-19T04:28:38Z,pre_sentiment,gpt-4.1-mini,284,1,285
2025-08-19T04:28:42Z,sentiment,gpt-4.1-mini,9635,249,9884
2025-08-19T04:28:42Z,pre_sentiment,gpt-4.1-mini,293,1,294
2025-08-19T04:28:45Z,sentiment,gpt-4.1-mini,7182,245,7427
2025-08-19T04:28:45Z,pre_sentiment,gpt-4.1-mini,284,1,285
2025-08-19T04:28:48Z,sentiment,gpt-4.1-mini,4217,226,4443
2025-08-19T04:28:48Z,pre_sentiment,gpt-4.1-mini,286,1,287
2025-08-19T04:28:53Z,sentiment,gpt-4.1-mini,1393,203,1596
2025-08-19T04:28:53Z,pre_sentiment,gpt-4.1-mini,290,1,291
2025-08-19T04:28:56Z,sentiment,gpt-4.1-mini,1453,183,1636
2025-08-19T04:28:56Z,pre_sentiment,gpt-4.1-mini,284,1,285
2025-08-19T04:28:59Z,sentiment,gpt-4.1-mini,2065,205,2270
2025-08-19T04:28:59Z,pre_sentiment,gpt-4.1-mini,278,1,279
2025-08-19T04:29:01Z,sentiment,gpt-4.1-mini,1078,117,1195
2025-08-19T04:29:05Z,pre_sentiment,gpt-4.1-mini,289,1,290
2025-08-19T04:29:07Z,sentiment,gpt-4.1-mini,1329,175,1504
2025-08-19T04:29:08Z,pre_sentiment,gpt-4.1-mini,283,1,284
2025-08-19T04:29:11Z,sentiment,gpt-4.1-mini,2556,194,2750
2025-08-19T04:29:31Z,pre_sentiment,gpt-4.1-mini,290,1,291
2025-08-19T04:29:36Z,pre_sentiment,gpt-4.1-mini,274,1,275
2025-08-19T04:29:38Z,sentiment,gpt-4.1-mini,1875,122,1997
2025-08-19T04:29:38Z,pre_sentiment,gpt-4.1-mini,274,1,275
2025-08-19T04:29:38Z,pre_sentiment,gpt-4.1-mini,278,1,279
2025-08-19T04:29:45Z,pre_sentiment,gpt-4.1-mini,293,1,294
2025-08-19T04:29:46Z,pre_sentiment,gpt-4.1-mini,283,1,284
2025-08-19T04:29:49Z,sentiment,gpt-4.1-mini,4251,222,4473
2025-08-19T04:29:50Z,pre_sentiment,gpt-4.1-mini,284,1,285
2025-08-19T04:29:52Z,sentiment,gpt-4.1-mini,1430,161,1591
2025-08-19T04:29:53Z,pre_sentiment,gpt-4.1-mini,279,1,280
2025-08-19T04:29:55Z,sentiment,gpt-4.1-mini,1504,191,1695
2025-08-19T04:29:56Z,pre_sentiment,gpt-4.1-mini,289,1,290
2025-08-19T04:29:56Z,pre_sentiment,gpt-4.1-mini,282,1,283
2025-08-19T04:29:58Z,sentiment,gpt-4.1-mini,1442,198,1640
2025-08-19T04:30:10Z,pre_sentiment,gpt-4.1-mini,284,1,285
2025-08-19T04:30:23Z,pre_sentiment,gpt-4.1-mini,284,1,285
2025-08-19T04:30:45Z,pre_sentiment,gpt-4.1-mini,284,1,285
2025-08-19T04:30:48Z,sentiment,gpt-4.1-mini,1442,208,1650
2025-08-19T04:30:48Z,pre_sentiment,gpt-4.1-mini,294,1,295
2025-08-19T04:30:48Z,pre_sentiment,gpt-4.1-mini,292,1,293
2025-08-19T04:30:51Z,sentiment,gpt-4.1-mini,1525,220,1745
2025-08-19T04:30:51Z,pre_sentiment,gpt-4.1-mini,292,1,293
2025-08-19T04:30:53Z,sentiment,gpt-4.1-mini,1452,124,1576
2025-08-19T04:31:11Z,pre_sentiment,gpt-4.1-mini,287,1,288
2025-08-19T04:31:12Z,pre_sentiment,gpt-4.1-mini,286,1,287
2025-08-19T04:31:14Z,sentiment,gpt-4.1-mini,1472,132,1604
2025-08-19T04:31:14Z,pre_sentiment,gpt-4.1-mini,284,1,285
2025-08-19T04:31:17Z,sentiment,gpt-4.1-mini,1188,169,1357
2025-08-19T04:31:17Z,pre_sentiment,gpt-4.1-mini,288,1,289
2025-08-19T04:31:19Z,sentiment,gpt-4.1-mini,1675,174,1849
2025-08-19T04:31:20Z,pre_sentiment,gpt-4.1-mini,297,1,298
2025-08-19T04:31:20Z,pre_sentiment,gpt-4.1-mini,295,1,296
2025-08-19T04:31:33Z,pre_sentiment,gpt-4.1-mini,286,1,287
2025-08-19T04:31:33Z,pre_sentiment,gpt-4.1-mini,283,1,284
2025-08-19T04:31:40Z,sentiment,gpt-4.1-mini,2219,217,2436
2025-08-19T04:31:41Z,pre_sentiment,gpt-4.1-mini,284,1,285
2025-08-19T04:31:44Z,sentiment,gpt-4.1-mini,924,119,1043
2025-08-19T04:31:44Z,pre_sentiment,gpt-4.1-mini,283,1,284
2025-08-19T04:31:47Z,sentiment,gpt-4.1-mini,2591,214,2805
2025-08-19T04:31:48Z,pre_sentiment,gpt-4.1-mini,285,1,286
2025-08-19T04:31:59Z,pre_sentiment,gpt-4.1-mini,288,1,289
2025-08-19T04:32:01Z,sentiment,gpt-4.1-mini,968,142,1110
2025-08-19T04:32:01Z,pre_sentiment,gpt-4.1-mini,280,1,281
2025-08-19T04:32:04Z,sentiment,gpt-4.1-mini,2138,212,2350
2025-08-19T04:32:04Z,pre_sentiment,gpt-4.1-mini,283,1,284
2025-08-19T04:32:04Z,pre_sentiment,gpt-4.1-mini,289,1,290
2025-08-19T04:32:06Z,sentiment,gpt-4.1-mini,1235,183,1418
2025-08-19T04:32:07Z,pre_sentiment,gpt-4.1-mini,282,1,283
2025-08-19T04:32:07Z,pre_sentiment,gpt-4.1-mini,326,1,327
2025-08-19T04:32:07Z,pre_sentiment,gpt-4.1-mini,287,1,288
2025-08-19T04:32:08Z,pre_sentiment,gpt-4.1-mini,281,1,282
2025-08-19T04:32:15Z,article_selection,gpt-4.1-mini,1120,9,1129
2025-08-19T04:32:15Z,article_selection,gpt-4.1-mini,1679,12,1691
2025-08-19T04:32:16Z,article_selection,gpt-4.1-mini,475,9,484
2025-08-19T04:32:16Z,article_selection,gpt-4.1-mini,697,12,709
2025-08-19T04:32:17Z,article_selection,gpt-4.1-mini,555,7,562
2025-08-19T04:32:18Z,article_selection,gpt-4.1-mini,752,12,764
2025-08-19T04:32:37Z,final_summary_en,gpt-4.1-mini,3901,1212,5113
2025-08-19T04:32:53Z,final_summary_en,gpt-4.1-mini,1285,1078,2363
2025-08-19T04:33:09Z,final_summary_en,gpt-4.1-mini,932,1137,2069
2025-08-19T04:33:22Z,final_summary_en,gpt-4.1-mini,1208,1024,2232
2025-08-19T04:33:49Z,final_summary_en,gpt-4.1-mini,6969,1656,8625
2025-08-19T04:34:08Z,final_summary_en,gpt-4.1-mini,2573,1090,3663
2025-08-19T04:34:27Z,final_summary_en,gpt-4.1-mini,1068,1068,2136
2025-08-19T04:34:44Z,final_summary_en,gpt-4.1-mini,2295,1334,3629
2025-08-19T04:35:01Z,final_summary_en,gpt-4.1-mini,1545,1222,2767
2025-08-19T04:35:24Z,final_summary_en,gpt-4.1-mini,1897,952,2849
2025-08-19T04:35:45Z,final_summary_en,gpt-4.1-mini,2372,1296,3668
2025-08-19T04:36:03Z,final_summary_en,gpt-4.1-mini,1908,1143,3051
2025-08-19T04:36:28Z,final_summary_en,gpt-4.1-mini,3655,1532,5187
2025-08-19T04:36:42Z,final_summary_en,gpt-4.1-mini,1257,1008,2265
2025-08-19T04:36:53Z,final_summary_en,gpt-4.1-mini,1214,899,2113
2025-08-19T04:37:22Z,final_summary_en,gpt-4.1-mini,1791,1137,2928
2025-08-19T04:37:37Z,final_summary_en,gpt-4.1-mini,1417,1024,2441
2025-08-19T04:37:53Z,final_summary_en,gpt-4.1-mini,1977,1172,3149
2025-08-19T04:38:14Z,final_summary_en,gpt-4.1-mini,1148,1040,2188
2025-08-19T04:38:32Z,final_summary_en,gpt-4.1-mini,1823,1205,3028
2025-08-19T04:38:50Z,final_summary_en,gpt-4.1-mini,3985,1388,5373
2025-08-19T04:39:08Z,final_summary_en,gpt-4.1-mini,1189,1239,2428
2025-08-19T04:40:25Z,category_summary,gpt-4.1-mini,130,35,165
2025-08-19T04:40:27Z,category_summary,gpt-4.1-mini,135,33,168
2025-08-19T04:40:29Z,category_summary,gpt-4.1-mini,124,27,151
2025-08-19T04:40:30Z,category_summary,gpt-4.1-mini,116,33,149
2025-08-19T04:40:32Z,category_summary,gpt-4.1-mini,133,36,169
2025-08-19T04:40:35Z,category_summary,gpt-4.1-mini,114,35,149
2025-08-19T04:40:36Z,RUN_TOTAL,,179013,34828,213841
2025-08-20T04:27:11Z,pre_sentiment,gpt-4.1-mini,278,1,279
2025-08-20T04:27:12Z,pre_sentiment,gpt-4.1-mini,281,1,282
2025-08-20T04:27:13Z,pre_sentiment,gpt-4.1-mini,291,1,292
2025-08-20T04:27:13Z,pre_sentiment,gpt-4.1-mini,277,1,278
2025-08-20T04:27:14Z,pre_sentiment,gpt-4.1-mini,293,1,294
2025-08-20T04:27:18Z,sentiment,gpt-4.1-mini,3329,220,3549
2025-08-20T04:27:19Z,pre_sentiment,gpt-4.1-mini,276,1,277
2025-08-20T04:27:19Z,pre_sentiment,gpt-4.1-mini,282,1,283
2025-08-20T04:27:21Z,sentiment,gpt-4.1-mini,1193,136,1329
2025-08-20T04:27:22Z,pre_sentiment,gpt-4.1-mini,290,1,291
2025-08-20T04:27:22Z,pre_sentiment,gpt-4.1-mini,289,1,290
2025-08-20T04:27:22Z,pre_sentiment,gpt-4.1-mini,282,1,283
2025-08-20T04:27:24Z,sentiment,gpt-4.1-mini,1639,123,1762
2025-08-20T04:27:24Z,pre_sentiment,gpt-4.1-mini,282,1,283
2025-08-20T04:27:26Z,sentiment,gpt-4.1-mini,1281,203,1484
2025-08-20T04:27:26Z,pre_sentiment,gpt-4.1-mini,282,1,283
2025-08-20T04:27:27Z,pre_sentiment,gpt-4.1-mini,287,1,288
2025-08-20T04:27:27Z,pre_sentiment,gpt-4.1-mini,285,1,286
2025-08-20T04:27:28Z,pre_sentiment,gpt-4.1-mini,284,1,285
2025-08-20T04:27:30Z,sentiment,gpt-4.1-mini,1446,163,1609
2025-08-20T04:27:40Z,pre_sentiment,gpt-4.1-mini,290,1,291
2025-08-20T04:27:41Z,pre_sentiment,gpt-4.1-mini,280,1,281
2025-08-20T04:27:43Z,sentiment,gpt-4.1-mini,1403,216,1619
2025-08-20T04:27:43Z,pre_sentiment,gpt-4.1-mini,277,1,278
2025-08-20T04:27:44Z,pre_sentiment,gpt-4.1-mini,281,1,282
2025-08-20T04:27:44Z,pre_sentiment,gpt-4.1-mini,287,1,288
2025-08-20T04:27:53Z,sentiment,gpt-4.1-mini,1398,144,1542
2025-08-20T04:28:06Z,pre_sentiment,gpt-4.1-mini,282,1,283
2025-08-20T04:28:09Z,pre_sentiment,gpt-4.1-mini,282,1,283
2025-08-20T04:28:12Z,sentiment,gpt-4.1-mini,1559,205,1764
2025-08-20T04:28:12Z,pre_sentiment,gpt-4.1-mini,279,1,280
2025-08-20T04:28:14Z,sentiment,gpt-4.1-mini,1576,194,1770
2025-08-20T04:28:14Z,pre_sentiment,gpt-4.1-mini,281,1,282
2025-08-20T04:28:17Z,sentiment,gpt-4.1-mini,1450,180,1630
2025-08-20T04:28:17Z,pre_sentiment,gpt-4.1-mini,290,1,291
2025-08-20T04:28:20Z,sentiment,gpt-4.1-mini,1205,191,1396
2025-08-20T04:28:20Z,pre_sentiment,gpt-4.1-mini,283,1,284
2025-08-20T04:28:23Z,sentiment,gpt-4.1-mini,2168,209,2377
2025-08-20T04:28:23Z,pre_sentiment,gpt-4.1-mini,280,1,281
2025-08-20T04:28:26Z,sentiment,gpt-4.1-mini,1931,226,2157
2025-08-20T04:28:27Z,pre_sentiment,gpt-4.1-mini,278,1,279
2025-08-20T04:28:29Z,sentiment,gpt-4.1-mini,1441,209,1650
2025-08-20T04:28:29Z,pre_sentiment,gpt-4.1-mini,278,1,279
2025-08-20T04:28:30Z,pre_sentiment,gpt-4.1-mini,288,1,289
2025-08-20T04:28:30Z,pre_sentiment,gpt-4.1-mini,289,1,290
2025-08-20T04:28:32Z,sentiment,gpt-4.1-mini,2219,230,2449
2025-08-20T04:28:51Z,pre_sentiment,gpt-4.1-mini,291,1,292
2025-08-20T04:28:52Z,sentiment,gpt-4.1-mini,898,89,987
2025-08-20T04:28:53Z,pre_sentiment,gpt-4.1-mini,298,1,299
2025-08-20T04:28:54Z,sentiment,gpt-4.1-mini,925,119,1044
2025-08-20T04:28:55Z,pre_sentiment,gpt-4.1-mini,290,1,291
2025-08-20T04:28:56Z,sentiment,gpt-4.1-mini,899,90,989
2025-08-20T04:28:56Z,pre_sentiment,gpt-4.1-mini,298,1,299
2025-08-20T04:28:58Z,sentiment,gpt-4.1-mini,912,89,1001
2025-08-20T04:28:58Z,pre_sentiment,gpt-4.1-mini,297,1,298
2025-08-20T04:28:59Z,sentiment,gpt-4.1-mini,904,85,989
2025-08-20T04:29:00Z,pre_sentiment,gpt-4.1-mini,301,1,302
2025-08-20T04:29:02Z,sentiment,gpt-4.1-mini,965,167,1132
2025-08-20T04:29:02Z,pre_sentiment,gpt-4.1-mini,291,1,292
2025-08-20T04:29:03Z,pre_sentiment,gpt-4.1-mini,296,1,297
2025-08-20T04:29:05Z,sentiment,gpt-4.1-mini,2318,179,2497
2025-08-20T04:29:05Z,pre_sentiment,gpt-4.1-mini,298,1,299
2025-08-20T04:29:08Z,sentiment,gpt-4.1-mini,1940,177,2117
2025-08-20T04:29:08Z,pre_sentiment,gpt-4.1-mini,294,1,295
2025-08-20T04:29:11Z,sentiment,gpt-4.1-mini,924,156,1080
2025-08-20T04:29:11Z,pre_sentiment,gpt-4.1-mini,297,1,298
2025-08-20T04:29:12Z,sentiment,gpt-4.1-mini,2334,157,2491
2025-08-20T04:29:13Z,pre_sentiment,gpt-4.1-mini,305,1,306
2025-08-20T04:29:14Z,sentiment,gpt-4.1-mini,1768,149,1917
2025-08-20T04:29:15Z,pre_sentiment,gpt-4.1-mini,297,1,298
2025-08-20T04:29:17Z,sentiment,gpt-4.1-mini,1272,148,1420
2025-08-20T04:29:17Z,pre_sentiment,gpt-4.1-mini,299,1,300
2025-08-20T04:29:19Z,sentiment,gpt-4.1-mini,3031,206,3237
2025-08-20T04:29:20Z,pre_sentiment,gpt-4.1-mini,299,1,300
2025-08-20T04:29:22Z,sentiment,gpt-4.1-mini,4178,197,4375
2025-08-20T04:29:35Z,pre_sentiment,gpt-4.1-mini,288,1,289
2025-08-20T04:29:37Z,sentiment,gpt-4.1-mini,1549,120,1669
2025-08-20T04:29:37Z,pre_sentiment,gpt-4.1-mini,287,1,288
2025-08-20T04:29:40Z,sentiment,gpt-4.1-mini,1426,142,1568
2025-08-20T04:29:40Z,pre_sentiment,gpt-4.1-mini,289,1,290
2025-08-20T04:29:42Z,sentiment,gpt-4.1-mini,1519,208,1727
2025-08-20T04:29:43Z,pre_sentiment,gpt-4.1-mini,282,1,283
2025-08-20T04:29:44Z,sentiment,gpt-4.1-mini,1338,182,1520
2025-08-20T04:29:45Z,pre_sentiment,gpt-4.1-mini,276,1,277
2025-08-20T04:29:47Z,sentiment,gpt-4.1-mini,4229,228,4457
2025-08-20T04:29:48Z,pre_sentiment,gpt-4.1-mini,282,1,283
2025-08-20T04:29:49Z,sentiment,gpt-4.1-mini,1983,188,2171
2025-08-20T04:29:50Z,pre_sentiment,gpt-4.1-mini,283,1,284
2025-08-20T04:29:51Z,sentiment,gpt-4.1-mini,1044,168,1212
2025-08-20T04:29:52Z,pre_sentiment,gpt-4.1-mini,286,1,287
2025-08-20T04:29:54Z,sentiment,gpt-4.1-mini,2057,235,2292
2025-08-20T04:29:54Z,pre_sentiment,gpt-4.1-mini,288,1,289
2025-08-20T04:29:56Z,sentiment,gpt-4.1-mini,2032,221,2253
2025-08-20T04:29:57Z,pre_sentiment,gpt-4.1-mini,291,1,292
2025-08-20T04:29:59Z,sentiment,gpt-4.1-mini,2194,174,2368
2025-08-20T04:30:04Z,pre_sentiment,gpt-4.1-mini,292,1,293
2025-08-20T04:30:06Z,sentiment,gpt-4.1-mini,2067,171,2238
2025-08-20T04:30:06Z,pre_sentiment,gpt-4.1-mini,282,1,283
2025-08-20T04:30:09Z,sentiment,gpt-4.1-mini,2855,198,3053
2025-08-20T04:30:15Z,pre_sentiment,gpt-4.1-mini,290,1,291
2025-08-20T04:30:20Z,pre_sentiment,gpt-4.1-mini,278,1,279
2025-08-20T04:30:21Z,pre_sentiment,gpt-4.1-mini,278,1,279
2025-08-20T04:30:23Z,sentiment,gpt-4.1-mini,2965,157,3122
2025-08-20T04:30:23Z,pre_sentiment,gpt-4.1-mini,275,1,276
2025-08-20T04:30:24Z,pre_sentiment,gpt-4.1-mini,274,1,275
2025-08-20T04:30:26Z,sentiment,gpt-4.1-mini,1946,228,2174
2025-08-20T04:30:40Z,pre_sentiment,gpt-4.1-mini,279,1,280
2025-08-20T04:30:42Z,sentiment,gpt-4.1-mini,1408,198,1606
2025-08-20T04:30:43Z,pre_sentiment,gpt-4.1-mini,283,1,284
2025-08-20T04:30:45Z,sentiment,gpt-4.1-mini,1717,203,1920
2025-08-20T04:30:45Z,pre_sentiment,gpt-4.1-mini,288,1,289
2025-08-20T04:30:47Z,sentiment,gpt-4.1-mini,1835,195,2030
2025-08-20T04:30:48Z,pre_sentiment,gpt-4.1-mini,278,1,279
2025-08-20T04:30:48Z,pre_sentiment,gpt-4.1-mini,286,1,287
2025-08-20T04:30:50Z,sentiment,gpt-4.1-mini,1354,203,1557
2025-08-20T04:30:51Z,pre_sentiment,gpt-4.1-mini,286,1,287
2025-08-20T04:30:51Z,pre_sentiment,gpt-4.1-mini,280,1,281
2025-08-20T04:31:02Z,pre_sentiment,gpt-4.1-mini,285,1,286
2025-08-20T04:31:02Z,pre_sentiment,gpt-4.1-mini,288,1,289
2025-08-20T04:31:05Z,sentiment,gpt-4.1-mini,2071,225,2296
2025-08-20T04:31:19Z,pre_sentiment,gpt-4.1-mini,285,1,286
2025-08-20T04:31:41Z,pre_sentiment,gpt-4.1-mini,294,1,295
2025-08-20T04:31:58Z,pre_sentiment,gpt-4.1-mini,284,1,285
2025-08-20T04:31:58Z,pre_sentiment,gpt-4.1-mini,279,1,280
2025-08-20T04:32:00Z,sentiment,gpt-4.1-mini,1144,160,1304
2025-08-20T04:32:01Z,pre_sentiment,gpt-4.1-mini,280,1,281
2025-08-20T04:32:01Z,pre_sentiment,gpt-4.1-mini,279,1,280
2025-08-20T04:32:03Z,sentiment,gpt-4.1-mini,1304,138,1442
2025-08-20T04:32:03Z,pre_sentiment,gpt-4.1-mini,283,1,284
2025-08-20T04:32:03Z,pre_sentiment,gpt-4.1-mini,292,1,293
2025-08-20T04:32:04Z,pre_sentiment,gpt-4.1-mini,293,1,294
2025-08-20T04:32:06Z,sentiment,gpt-4.1-mini,2146,180,2326
2025-08-20T04:32:06Z,pre_sentiment,gpt-4.1-mini,290,1,291
2025-08-20T04:32:21Z,pre_sentiment,gpt-4.1-mini,300,1,301
2025-08-20T04:32:24Z,sentiment,gpt-4.1-mini,2474,209,2683
2025-08-20T04:32:24Z,pre_sentiment,gpt-4.1-mini,282,1,283
2025-08-20T04:32:24Z,pre_sentiment,gpt-4.1-mini,294,1,295
2025-08-20T04:32:27Z,sentiment,gpt-4.1-mini,2839,215,3054
2025-08-20T04:32:27Z,pre_sentiment,gpt-4.1-mini,286,1,287
2025-08-20T04:32:41Z,pre_sentiment,gpt-4.1-mini,286,1,287
2025-08-20T04:32:44Z,sentiment,gpt-4.1-mini,1415,180,1595
2025-08-20T04:32:44Z,pre_sentiment,gpt-4.1-mini,280,1,281
2025-08-20T04:32:45Z,pre_sentiment,gpt-4.1-mini,281,1,282
2025-08-20T04:32:45Z,pre_sentiment,gpt-4.1-mini,284,1,285
2025-08-20T04:32:47Z,sentiment,gpt-4.1-mini,1279,215,1494
2025-08-20T04:32:56Z,article_selection,gpt-4.1-mini,1211,12,1223
2025-08-20T04:32:57Z,article_selection,gpt-4.1-mini,1034,12,1046
2025-08-20T04:32:57Z,article_selection,gpt-4.1-mini,974,12,986
2025-08-20T04:32:58Z,article_selection,gpt-4.1-mini,1916,9,1925
2025-08-20T04:32:58Z,article_selection,gpt-4.1-mini,806,12,818
2025-08-20T04:33:18Z,final_summary_en,gpt-4.1-mini,1690,1144,2834
2025-08-20T04:33:36Z,final_summary_en,gpt-4.1-mini,653,908,1561
2025-08-20T04:33:51Z,final_summary_en,gpt-4.1-mini,1592,1186,2778
2025-08-20T04:34:07Z,final_summary_en,gpt-4.1-mini,3996,1369,5365
2025-08-20T04:34:21Z,final_summary_en,gpt-4.1-mini,960,1002,1962
2025-08-20T04:34:38Z,final_summary_en,gpt-4.1-mini,2034,1142,3176
2025-08-20T04:34:51Z,final_summary_en,gpt-4.1-mini,1314,996,2310
2025-08-20T04:35:06Z,final_summary_en,gpt-4.1-mini,1827,1033,2860
2025-08-20T04:35:22Z,final_summary_en,gpt-4.1-mini,1301,1042,2343
2025-08-20T04:35:39Z,final_summary_en,gpt-4.1-mini,1978,1210,3188
2025-08-20T04:35:53Z,final_summary_en,gpt-4.1-mini,1280,956,2236
2025-08-20T04:36:07Z,final_summary_en,gpt-4.1-mini,1168,1073,2241
2025-08-20T04:36:21Z,final_summary_en,gpt-4.1-mini,3923,1193,5116
2025-08-20T04:36:35Z,final_summary_en,gpt-4.1-mini,1706,1135,2841
2025-08-20T04:36:49Z,final_summary_en,gpt-4.1-mini,1890,1084,2974
2025-08-20T04:37:01Z,final_summary_en,gpt-4.1-mini,2600,1023,3623
2025-08-20T04:37:19Z,final_summary_en,gpt-4.1-mini,1822,1276,3098
2025-08-20T04:37:35Z,final_summary_en,gpt-4.1-mini,1792,1196,2988
2025-08-20T04:37:49Z,final_summary_en,gpt-4.1-mini,702,1032,1734
2025-08-20T04:38:04Z,final_summary_en,gpt-4.1-mini,1691,1192,2883
2025-08-20T04:40:02Z,category_summary,gpt-4.1-mini,119,25,144
2025-08-20T04:40:05Z,category_summary,gpt-4.1-mini,131,30,161
2025-08-20T04:40:08Z,category_summary,gpt-4.1-mini,137,32,169
2025-08-20T04:40:12Z,category_summary,gpt-4.1-mini,135,36,171
2025-08-20T04:40:14Z,category_summary,gpt-4.1-mini,132,24,156
2025-08-20T04:40:15Z,RUN_TOTAL,,166971,32284,199255
2025-08-21T04:26:32Z,pre_sentiment,gpt-4.1-mini,278,1,279
2025-08-21T04:26:32Z,pre_sentiment,gpt-4.1-mini,286,1,287
2025-08-21T04:26:33Z,pre_sentiment,gpt-4.1-mini,286,1,287
2025-08-21T04:26:33Z,pre_sentiment,gpt-4.1-mini,285,1,286
2025-08-21T04:26:34Z,pre_sentiment,gpt-4.1-mini,286,1,287
2025-08-21T04:26:34Z,pre_sentiment,gpt-4.1-mini,282,1,283
2025-08-21T04:26:35Z,pre_sentiment,gpt-4.1-mini,280,1,281
2025-08-21T04:26:35Z,pre_sentiment,gpt-4.1-mini,285,1,286
2025-08-21T04:26:40Z,sentiment,gpt-4.1-mini,1685,227,1912
2025-08-21T04:26:40Z,pre_sentiment,gpt-4.1-mini,281,1,282
2025-08-21T04:26:41Z,pre_sentiment,gpt-4.1-mini,279,1,280
2025-08-21T04:26:41Z,pre_sentiment,gpt-4.1-mini,288,1,289
2025-08-21T04:26:42Z,pre_sentiment,gpt-4.1-mini,290,1,291
2025-08-21T04:26:42Z,pre_sentiment,gpt-4.1-mini,284,1,285
2025-08-21T04:26:42Z,pre_sentiment,gpt-4.1-mini,284,1,285
2025-08-21T04:26:45Z,sentiment,gpt-4.1-mini,2059,212,2271
2025-08-21T04:26:45Z,pre_sentiment,gpt-4.1-mini,280,1,281
2025-08-21T04:26:58Z,pre_sentiment,gpt-4.1-mini,278,1,279
2025-08-21T04:26:58Z,pre_sentiment,gpt-4.1-mini,282,1,283
2025-08-21T04:26:59Z,pre_sentiment,gpt-4.1-mini,288,1,289
2025-08-21T04:26:59Z,pre_sentiment,gpt-4.1-mini,282,1,283
2025-08-21T04:26:59Z,pre_sentiment,gpt-4.1-mini,280,1,281
2025-08-21T04:27:01Z,sentiment,gpt-4.1-mini,1422,181,1603
2025-08-21T04:27:10Z,pre_sentiment,gpt-4.1-mini,282,1,283
2025-08-21T04:27:15Z,pre_sentiment,gpt-4.1-mini,283,1,284
2025-08-21T04:27:19Z,sentiment,gpt-4.1-mini,1437,199,1636
2025-08-21T04:27:19Z,pre_sentiment,gpt-4.1-mini,282,1,283
2025-08-21T04:27:22Z,sentiment,gpt-4.1-mini,1836,213,2049
2025-08-21T04:27:23Z,pre_sentiment,gpt-4.1-mini,276,1,277
2025-08-21T04:27:26Z,sentiment,gpt-4.1-mini,1844,174,2018
2025-08-21T04:27:27Z,pre_sentiment,gpt-4.1-mini,282,1,283
2025-08-21T04:27:29Z,sentiment,gpt-4.1-mini,1382,175,1557
2025-08-21T04:27:29Z,pre_sentiment,gpt-4.1-mini,279,1,280
2025-08-21T04:27:32Z,sentiment,gpt-4.1-mini,1467,186,1653
2025-08-21T04:27:32Z,pre_sentiment,gpt-4.1-mini,277,1,278
2025-08-21T04:27:32Z,pre_sentiment,gpt-4.1-mini,279,1,280
2025-08-21T04:27:36Z,sentiment,gpt-4.1-mini,1520,221,1741
2025-08-21T04:27:37Z,pre_sentiment,gpt-4.1-mini,279,1,280
2025-08-21T04:27:41Z,sentiment,gpt-4.1-mini,2518,261,2779
2025-08-21T04:27:42Z,pre_sentiment,gpt-4.1-mini,283,1,284
2025-08-21T04:27:46Z,sentiment,gpt-4.1-mini,1593,194,1787
2025-08-21T04:28:07Z,pre_sentiment,gpt-4.1-mini,306,1,307
2025-08-21T04:28:09Z,sentiment,gpt-4.1-mini,1246,220,1466
2025-08-21T04:28:10Z,pre_sentiment,gpt-4.1-mini,301,1,302
2025-08-21T04:28:12Z,sentiment,gpt-4.1-mini,924,127,1051
2025-08-21T04:28:12Z,pre_sentiment,gpt-4.1-mini,296,1,297
2025-08-21T04:28:13Z,sentiment,gpt-4.1-mini,916,85,1001
2025-08-21T04:28:14Z,pre_sentiment,gpt-4.1-mini,295,1,296
2025-08-21T04:28:16Z,sentiment,gpt-4.1-mini,1267,162,1429
2025-08-21T04:28:16Z,pre_sentiment,gpt-4.1-mini,298,1,299
2025-08-21T04:28:17Z,pre_sentiment,gpt-4.1-mini,301,1,302
2025-08-21T04:28:20Z,sentiment,gpt-4.1-mini,6923,225,7148
2025-08-21T04:28:21Z,pre_sentiment,gpt-4.1-mini,299,1,300
2025-08-21T04:28:23Z,sentiment,gpt-4.1-mini,3912,187,4099
2025-08-21T04:28:24Z,pre_sentiment,gpt-4.1-mini,304,1,305
2025-08-21T04:28:27Z,sentiment,gpt-4.1-mini,6898,212,7110
2025-08-21T04:28:29Z,pre_sentiment,gpt-4.1-mini,295,1,296
2025-08-21T04:28:32Z,sentiment,gpt-4.1-mini,7786,245,8031
2025-08-21T04:28:32Z,pre_sentiment,gpt-4.1-mini,302,1,303
2025-08-21T04:28:36Z,sentiment,gpt-4.1-mini,8204,197,8401
2025-08-21T04:28:37Z,pre_sentiment,gpt-4.1-mini,293,1,294
2025-08-21T04:28:40Z,sentiment,gpt-4.1-mini,6381,234,6615
2025-08-21T04:28:41Z,pre_sentiment,gpt-4.1-mini,308,1,309
2025-08-21T04:28:48Z,sentiment,gpt-4.1-mini,27372,273,27645
2025-08-21T04:28:49Z,pre_sentiment,gpt-4.1-mini,307,1,308
2025-08-21T04:28:51Z,sentiment,gpt-4.1-mini,1165,196,1361
2025-08-21T04:28:52Z,pre_sentiment,gpt-4.1-mini,296,1,297
2025-08-21T04:28:54Z,sentiment,gpt-4.1-mini,3784,193,3977
2025-08-21T04:28:55Z,pre_sentiment,gpt-4.1-mini,292,1,293
2025-08-21T04:29:01Z,sentiment,gpt-4.1-mini,7408,237,7645
2025-08-21T04:29:15Z,pre_sentiment,gpt-4.1-mini,284,1,285
2025-08-21T04:29:18Z,sentiment,gpt-4.1-mini,2182,219,2401
2025-08-21T04:29:22Z,pre_sentiment,gpt-4.1-mini,288,1,289
2025-08-21T04:29:24Z,sentiment,gpt-4.1-mini,1327,131,1458
2025-08-21T04:29:25Z,pre_sentiment,gpt-4.1-mini,288,1,289
2025-08-21T04:29:27Z,sentiment,gpt-4.1-mini,2447,154,2601
2025-08-21T04:29:28Z,pre_sentiment,gpt-4.1-mini,296,1,297
2025-08-21T04:29:30Z,sentiment,gpt-4.1-mini,888,95,983
2025-08-21T04:29:32Z,pre_sentiment,gpt-4.1-mini,289,1,290
2025-08-21T04:29:37Z,sentiment,gpt-4.1-mini,2039,173,2212
2025-08-21T04:29:39Z,pre_sentiment,gpt-4.1-mini,289,1,290
2025-08-21T04:29:42Z,sentiment,gpt-4.1-mini,1966,195,2161
2025-08-21T04:29:44Z,pre_sentiment,gpt-4.1-mini,282,1,283
2025-08-21T04:29:48Z,sentiment,gpt-4.1-mini,1032,170,1202
2025-08-21T04:29:49Z,pre_sentiment,gpt-4.1-mini,276,1,277
2025-08-21T04:29:52Z,sentiment,gpt-4.1-mini,1102,167,1269
2025-08-21T04:29:52Z,pre_sentiment,gpt-4.1-mini,289,1,290
2025-08-21T04:29:54Z,sentiment,gpt-4.1-mini,2358,156,2514
2025-08-21T04:29:55Z,pre_sentiment,gpt-4.1-mini,294,1,295
2025-08-21T04:29:58Z,sentiment,gpt-4.1-mini,2616,225,2841
2025-08-21T04:30:03Z,pre_sentiment,gpt-4.1-mini,285,1,286
2025-08-21T04:30:06Z,sentiment,gpt-4.1-mini,2839,224,3063
2025-08-21T04:30:07Z,pre_sentiment,gpt-4.1-mini,289,1,290
2025-08-21T04:30:10Z,sentiment,gpt-4.1-mini,1247,139,1386
2025-08-21T04:30:15Z,pre_sentiment,gpt-4.1-mini,291,1,292
2025-08-21T04:30:18Z,sentiment,gpt-4.1-mini,2405,179,2584
2025-08-21T04:30:23Z,pre_sentiment,gpt-4.1-mini,280,1,281
2025-08-21T04:30:23Z,pre_sentiment,gpt-4.1-mini,275,1,276
2025-08-21T04:30:25Z,pre_sentiment,gpt-4.1-mini,274,1,275
2025-08-21T04:30:29Z,sentiment,gpt-4.1-mini,1820,242,2062
2025-08-21T04:30:31Z,pre_sentiment,gpt-4.1-mini,284,1,285
2025-08-21T04:30:31Z,pre_sentiment,gpt-4.1-mini,276,1,277
2025-08-21T04:30:35Z,pre_sentiment,gpt-4.1-mini,276,1,277
2025-08-21T04:30:36Z,pre_sentiment,gpt-4.1-mini,274,1,275
2025-08-21T04:30:36Z,pre_sentiment,gpt-4.1-mini,278,1,279
2025-08-21T04:30:54Z,pre_sentiment,gpt-4.1-mini,288,1,289
2025-08-21T04:30:57Z,sentiment,gpt-4.1-mini,1416,204,1620
2025-08-21T04:30:57Z,pre_sentiment,gpt-4.1-mini,279,1,280
2025-08-21T04:31:01Z,sentiment,gpt-4.1-mini,1366,180,1546
2025-08-21T04:31:01Z,pre_sentiment,gpt-4.1-mini,284,1,285
2025-08-21T04:31:04Z,sentiment,gpt-4.1-mini,1328,170,1498
2025-08-21T04:31:05Z,pre_sentiment,gpt-4.1-mini,287,1,288
2025-08-21T04:31:08Z,sentiment,gpt-4.1-mini,3841,242,4083
2025-08-21T04:31:09Z,pre_sentiment,gpt-4.1-mini,283,1,284
2025-08-21T04:31:12Z,sentiment,gpt-4.1-mini,2093,198,2291
2025-08-21T04:31:13Z,pre_sentiment,gpt-4.1-mini,277,1,278
2025-08-21T04:31:16Z,sentiment,gpt-4.1-mini,1281,211,1492
2025-08-21T04:31:17Z,pre_sentiment,gpt-4.1-mini,287,1,288
2025-08-21T04:31:21Z,sentiment,gpt-4.1-mini,1493,212,1705
2025-08-21T04:31:22Z,pre_sentiment,gpt-4.1-mini,282,1,283
2025-08-21T04:31:25Z,sentiment,gpt-4.1-mini,1490,192,1682
2025-08-21T04:32:22Z,pre_sentiment,gpt-4.1-mini,289,1,290
2025-08-21T04:32:24Z,sentiment,gpt-4.1-mini,1560,177,1737
2025-08-21T04:32:26Z,pre_sentiment,gpt-4.1-mini,288,1,289
2025-08-21T04:32:29Z,sentiment,gpt-4.1-mini,1601,186,1787
2025-08-21T04:32:48Z,pre_sentiment,gpt-4.1-mini,285,1,286
2025-08-21T04:32:52Z,sentiment,gpt-4.1-mini,1554,214,1768
2025-08-21T04:33:09Z,pre_sentiment,gpt-4.1-mini,289,1,290
2025-08-21T04:33:10Z,pre_sentiment,gpt-4.1-mini,285,1,286
2025-08-21T04:33:12Z,pre_sentiment,gpt-4.1-mini,300,1,301
2025-08-21T04:33:16Z,sentiment,gpt-4.1-mini,2493,210,2703
2025-08-21T04:33:32Z,pre_sentiment,gpt-4.1-mini,292,1,293
2025-08-21T04:33:32Z,pre_sentiment,gpt-4.1-mini,295,1,296
2025-08-21T04:33:33Z,pre_sentiment,gpt-4.1-mini,278,1,279
2025-08-21T04:33:35Z,sentiment,gpt-4.1-mini,977,142,1119
2025-08-21T04:33:36Z,pre_sentiment,gpt-4.1-mini,291,1,292
2025-08-21T04:33:36Z,pre_sentiment,gpt-4.1-mini,287,1,288
2025-08-21T04:33:36Z,pre_sentiment,gpt-4.1-mini,294,1,295
2025-08-21T04:33:37Z,pre_sentiment,gpt-4.1-mini,287,1,288
2025-08-21T04:33:45Z,article_selection,gpt-4.1-mini,1114,12,1126
2025-08-21T04:33:46Z,article_selection,gpt-4.1-mini,2248,12,2260
2025-08-21T04:33:47Z,article_selection,gpt-4.1-mini,976,12,988
2025-08-21T04:33:48Z,article_selection,gpt-4.1-mini,1376,12,1388
2025-08-21T04:33:48Z,article_selection,gpt-4.1-mini,1097,9,1106
2025-08-21T04:34:03Z,final_summary_en,gpt-4.1-mini,1456,1200,2656
2025-08-21T04:34:20Z,final_summary_en,gpt-4.1-mini,1808,1233,3041
2025-08-21T04:34:39Z,final_summary_en,gpt-4.1-mini,1593,1160,2753
2025-08-21T04:34:54Z,final_summary_en,gpt-4.1-mini,1117,928,2045
2025-08-21T04:35:10Z,final_summary_en,gpt-4.1-mini,1198,1029,2227
2025-08-21T04:35:30Z,final_summary_en,gpt-4.1-mini,1282,1178,2460
2025-08-21T04:35:58Z,final_summary_en,gpt-4.1-mini,27140,1391,28531
2025-08-21T04:36:16Z,final_summary_en,gpt-4.1-mini,1353,1248,2601
2025-08-21T04:36:33Z,final_summary_en,gpt-4.1-mini,2365,1017,3382
2025-08-21T04:36:55Z,final_summary_en,gpt-4.1-mini,1345,1293,2638
2025-08-21T04:37:23Z,final_summary_en,gpt-4.1-mini,1726,1118,2844
2025-08-21T04:37:36Z,final_summary_en,gpt-4.1-mini,776,968,1744
2025-08-21T04:37:52Z,final_summary_en,gpt-4.1-mini,2298,1068,3366
2025-08-21T04:38:10Z,final_summary_en,gpt-4.1-mini,7587,1163,8750
2025-08-21T04:38:26Z,final_summary_en,gpt-4.1-mini,6161,1081,7242
2025-08-21T04:38:45Z,final_summary_en,gpt-4.1-mini,7192,1336,8528
2025-08-21T04:39:04Z,final_summary_en,gpt-4.1-mini,1594,1256,2850
2025-08-21T04:39:23Z,final_summary_en,gpt-4.1-mini,1312,1409,2721
2025-08-21T04:39:42Z,final_summary_en,gpt-4.1-mini,2242,1248,3490
2025-08-21T04:41:16Z,category_summary,gpt-4.1-mini,133,28,161
2025-08-21T04:41:18Z,category_summary,gpt-4.1-mini,125,23,148
2025-08-21T04:41:20Z,category_summary,gpt-4.1-mini,115,24,139
2025-08-21T04:41:22Z,category_summary,gpt-4.1-mini,128,28,156
2025-08-21T04:41:24Z,category_summary,gpt-4.1-mini,130,34,164
2025-08-21T04:41:25Z,RUN_TOTAL,,255640,32648,288288
2025-08-22T04:25:46Z,pre_sentiment,gpt-4.1-mini,288,1,289
2025-08-22T04:25:46Z,pre_sentiment,gpt-4.1-mini,289,1,290
2025-08-22T04:25:47Z,pre_sentiment,gpt-4.1-mini,285,1,286
2025-08-22T04:25:49Z,sentiment,gpt-4.1-mini,2167,205,2372
2025-08-22T04:25:50Z,pre_sentiment,gpt-4.1-mini,283,1,284
2025-08-22T04:25:50Z,pre_sentiment,gpt-4.1-mini,281,1,282
2025-08-22T04:25:51Z,pre_sentiment,gpt-4.1-mini,277,1,278
2025-08-22T04:25:51Z,pre_sentiment,gpt-4.1-mini,284,1,285
2025-08-22T04:25:51Z,pre_sentiment,gpt-4.1-mini,279,1,280
2025-08-22T04:25:51Z,pre_sentiment,gpt-4.1-mini,286,1,287
2025-08-22T04:25:52Z,pre_sentiment,gpt-4.1-mini,277,1,278
2025-08-22T04:25:53Z,pre_sentiment,gpt-4.1-mini,284,1,285
2025-08-22T04:25:53Z,pre_sentiment,gpt-4.1-mini,283,1,284
2025-08-22T04:25:53Z,pre_sentiment,gpt-4.1-mini,293,1,294
2025-08-22T04:25:56Z,sentiment,gpt-4.1-mini,1874,155,2029
2025-08-22T04:25:56Z,pre_sentiment,gpt-4.1-mini,281,1,282
2025-08-22T04:25:57Z,pre_sentiment,gpt-4.1-mini,281,1,282
2025-08-22T04:25:58Z,sentiment,gpt-4.1-mini,902,91,993
2025-08-22T04:26:07Z,pre_sentiment,gpt-4.1-mini,286,1,287
2025-08-22T04:26:07Z,pre_sentiment,gpt-4.1-mini,284,1,285
2025-08-22T04:26:07Z,pre_sentiment,gpt-4.1-mini,281,1,282
2025-08-22T04:26:07Z,pre_sentiment,gpt-4.1-mini,285,1,286
2025-08-22T04:26:09Z,sentiment,gpt-4.1-mini,1499,136,1635
2025-08-22T04:26:09Z,pre_sentiment,gpt-4.1-mini,282,1,283
2025-08-22T04:26:09Z,pre_sentiment,gpt-4.1-mini,290,1,291
2025-08-22T04:26:29Z,pre_sentiment,gpt-4.1-mini,278,1,279
2025-08-22T04:26:31Z,sentiment,gpt-4.1-mini,2075,223,2298
2025-08-22T04:26:32Z,pre_sentiment,gpt-4.1-mini,289,1,290
2025-08-22T04:26:34Z,sentiment,gpt-4.1-mini,1802,203,2005
2025-08-22T04:26:34Z,pre_sentiment,gpt-4.1-mini,288,1,289
2025-08-22T04:26:34Z,pre_sentiment,gpt-4.1-mini,288,1,289
2025-08-22T04:26:39Z,sentiment,gpt-4.1-mini,1516,214,1730
2025-08-22T04:26:39Z,pre_sentiment,gpt-4.1-mini,276,1,277
2025-08-22T04:26:41Z,sentiment,gpt-4.1-mini,1449,167,1616
2025-08-22T04:26:41Z,pre_sentiment,gpt-4.1-mini,287,1,288
2025-08-22T04:26:43Z,sentiment,gpt-4.1-mini,1853,196,2049
2025-08-22T04:26:43Z,pre_sentiment,gpt-4.1-mini,280,1,281
2025-08-22T04:26:46Z,sentiment,gpt-4.1-mini,1525,213,1738
2025-08-22T04:26:46Z,pre_sentiment,gpt-4.1-mini,287,1,288
2025-08-22T04:26:48Z,sentiment,gpt-4.1-mini,1394,190,1584
2025-08-22T04:26:48Z,pre_sentiment,gpt-4.1-mini,286,1,287
2025-08-22T04:26:50Z,sentiment,gpt-4.1-mini,2323,170,2493
2025-08-22T04:26:50Z,pre_sentiment,gpt-4.1-mini,279,1,280
2025-08-22T04:26:52Z,sentiment,gpt-4.1-mini,1431,182,1613
2025-08-22T04:26:52Z,pre_sentiment,gpt-4.1-mini,284,1,285
2025-08-22T04:26:53Z,pre_sentiment,gpt-4.1-mini,281,1,282
2025-08-22T04:26:56Z,sentiment,gpt-4.1-mini,1656,241,1897
2025-08-22T04:27:11Z,pre_sentiment,gpt-4.1-mini,303,1,304
2025-08-22T04:27:12Z,pre_sentiment,gpt-4.1-mini,304,1,305
2025-08-22T04:27:14Z,sentiment,gpt-4.1-mini,1020,91,1111
2025-08-22T04:27:14Z,pre_sentiment,gpt-4.1-mini,306,1,307
2025-08-22T04:27:16Z,sentiment,gpt-4.1-mini,1519,199,1718
2025-08-22T04:27:16Z,pre_sentiment,gpt-4.1-mini,298,1,299
2025-08-22T04:27:17Z,pre_sentiment,gpt-4.1-mini,300,1,301
2025-08-22T04:27:17Z,pre_sentiment,gpt-4.1-mini,302,1,303
2025-08-22T04:27:19Z,sentiment,gpt-4.1-mini,1599,170,1769
2025-08-22T04:27:19Z,pre_sentiment,gpt-4.1-mini,306,1,307
2025-08-22T04:27:21Z,sentiment,gpt-4.1-mini,1246,222,1468
2025-08-22T04:27:22Z,pre_sentiment,gpt-4.1-mini,301,1,302
2025-08-22T04:27:23Z,sentiment,gpt-4.1-mini,924,116,1040
2025-08-22T04:27:23Z,pre_sentiment,gpt-4.1-mini,296,1,297
2025-08-22T04:27:24Z,sentiment,gpt-4.1-mini,916,110,1026
2025-08-22T04:27:26Z,pre_sentiment,gpt-4.1-mini,295,1,296
2025-08-22T04:27:28Z,sentiment,gpt-4.1-mini,1267,169,1436
2025-08-22T04:27:29Z,pre_sentiment,gpt-4.1-mini,298,1,299
2025-08-22T04:27:29Z,pre_sentiment,gpt-4.1-mini,301,1,302
2025-08-22T04:27:31Z,sentiment,gpt-4.1-mini,6923,206,7129
2025-08-22T04:27:32Z,pre_sentiment,gpt-4.1-mini,299,1,300
2025-08-22T04:27:34Z,sentiment,gpt-4.1-mini,3912,186,4098
2025-08-22T04:27:34Z,pre_sentiment,gpt-4.1-mini,304,1,305
2025-08-22T04:27:38Z,sentiment,gpt-4.1-mini,6898,212,7110
2025-08-22T04:27:48Z,pre_sentiment,gpt-4.1-mini,278,1,279
2025-08-22T04:27:50Z,sentiment,gpt-4.1-mini,1159,167,1326
2025-08-22T04:27:59Z,pre_sentiment,gpt-4.1-mini,293,1,294
2025-08-22T04:28:01Z,sentiment,gpt-4.1-mini,3290,177,3467
2025-08-22T04:28:01Z,pre_sentiment,gpt-4.1-mini,298,1,299
2025-08-22T04:28:03Z,sentiment,gpt-4.1-mini,1574,154,1728
2025-08-22T04:28:03Z,pre_sentiment,gpt-4.1-mini,283,1,284
2025-08-22T04:28:04Z,sentiment,gpt-4.1-mini,1301,122,1423
2025-08-22T04:28:05Z,pre_sentiment,gpt-4.1-mini,284,1,285
2025-08-22T04:28:07Z,sentiment,gpt-4.1-mini,1340,182,1522
2025-08-22T04:28:07Z,pre_sentiment,gpt-4.1-mini,294,1,295
2025-08-22T04:28:09Z,sentiment,gpt-4.1-mini,2432,180,2612
2025-08-22T04:28:10Z,pre_sentiment,gpt-4.1-mini,275,1,276
2025-08-22T04:28:12Z,sentiment,gpt-4.1-mini,1080,142,1222
2025-08-22T04:28:12Z,pre_sentiment,gpt-4.1-mini,293,1,294
2025-08-22T04:28:14Z,sentiment,gpt-4.1-mini,2391,182,2573
2025-08-22T04:28:14Z,pre_sentiment,gpt-4.1-mini,286,1,287
2025-08-22T04:28:16Z,sentiment,gpt-4.1-mini,2071,152,2223
2025-08-22T04:28:16Z,pre_sentiment,gpt-4.1-mini,288,1,289
2025-08-22T04:28:18Z,sentiment,gpt-4.1-mini,1327,144,1471
2025-08-22T04:28:23Z,pre_sentiment,gpt-4.1-mini,294,1,295
2025-08-22T04:28:25Z,sentiment,gpt-4.1-mini,2583,204,2787
2025-08-22T04:28:44Z,pre_sentiment,gpt-4.1-mini,260,1,261
2025-08-22T04:28:46Z,sentiment,gpt-4.1-mini,1840,225,2065
2025-08-22T04:28:47Z,pre_sentiment,gpt-4.1-mini,266,1,267
2025-08-22T04:28:58Z,pre_sentiment,gpt-4.1-mini,281,1,282
2025-08-22T04:29:00Z,sentiment,gpt-4.1-mini,1753,197,1950
2025-08-22T04:29:00Z,pre_sentiment,gpt-4.1-mini,283,1,284
2025-08-22T04:29:02Z,sentiment,gpt-4.1-mini,1384,171,1555
2025-08-22T04:29:02Z,pre_sentiment,gpt-4.1-mini,280,1,281
2025-08-22T04:29:04Z,sentiment,gpt-4.1-mini,2057,157,2214
2025-08-22T04:29:04Z,pre_sentiment,gpt-4.1-mini,284,1,285
2025-08-22T04:29:06Z,sentiment,gpt-4.1-mini,1571,211,1782
2025-08-22T04:29:07Z,pre_sentiment,gpt-4.1-mini,282,1,283
2025-08-22T04:29:07Z,pre_sentiment,gpt-4.1-mini,289,1,290
2025-08-22T04:29:09Z,sentiment,gpt-4.1-mini,1557,224,1781
2025-08-22T04:32:04Z,pre_sentiment,gpt-4.1-mini,288,1,289
2025-08-22T04:32:06Z,sentiment,gpt-4.1-mini,2295,136,2431
2025-08-22T04:32:06Z,pre_sentiment,gpt-4.1-mini,291,1,292
2025-08-22T04:32:09Z,sentiment,gpt-4.1-mini,1486,211,1697
2025-08-22T04:32:09Z,pre_sentiment,gpt-4.1-mini,287,1,288
2025-08-22T04:32:11Z,sentiment,gpt-4.1-mini,1000,161,1161
2025-08-22T04:32:12Z,pre_sentiment,gpt-4.1-mini,289,1,290
2025-08-22T04:32:13Z,sentiment,gpt-4.1-mini,1014,106,1120
2025-08-22T04:32:27Z,pre_sentiment,gpt-4.1-mini,287,1,288
2025-08-22T04:32:27Z,pre_sentiment,gpt-4.1-mini,288,1,289
2025-08-22T04:32:28Z,pre_sentiment,gpt-4.1-mini,289,1,290
2025-08-22T04:32:28Z,pre_sentiment,gpt-4.1-mini,284,1,285
2025-08-22T04:32:28Z,pre_sentiment,gpt-4.1-mini,283,1,284
2025-08-22T04:32:40Z,pre_sentiment,gpt-4.1-mini,278,1,279
2025-08-22T04:32:40Z,pre_sentiment,gpt-4.1-mini,288,1,289
2025-08-22T04:32:41Z,pre_sentiment,gpt-4.1-mini,279,1,280
2025-08-22T04:32:52Z,pre_sentiment,gpt-4.1-mini,287,1,288
2025-08-22T04:32:52Z,pre_sentiment,gpt-4.1-mini,289,1,290
2025-08-22T04:32:53Z,pre_sentiment,gpt-4.1-mini,282,1,283
2025-08-22T04:32:53Z,pre_sentiment,gpt-4.1-mini,282,1,283
2025-08-22T04:32:55Z,sentiment,gpt-4.1-mini,1431,214,1645
2025-08-22T04:32:55Z,pre_sentiment,gpt-4.1-mini,284,1,285
2025-08-22T04:32:55Z,pre_sentiment,gpt-4.1-mini,285,1,286
2025-08-22T04:32:56Z,pre_sentiment,gpt-4.1-mini,284,1,285
2025-08-22T04:32:57Z,sentiment,gpt-4.1-mini,1377,169,1546
2025-08-22T04:32:58Z,pre_sentiment,gpt-4.1-mini,283,1,284
2025-08-22T04:32:58Z,pre_sentiment,gpt-4.1-mini,284,1,285
2025-08-22T04:32:58Z,pre_sentiment,gpt-4.1-mini,281,1,282
2025-08-22T04:32:59Z,pre_sentiment,gpt-4.1-mini,298,1,299
2025-08-22T04:33:01Z,sentiment,gpt-4.1-mini,1319,186,1505
2025-08-22T04:33:08Z,pre_sentiment,gpt-4.1-mini,296,1,297
2025-08-22T04:33:10Z,sentiment,gpt-4.1-mini,5129,235,5364
2025-08-22T04:33:12Z,article_selection,gpt-4.1-mini,1609,9,1618
2025-08-22T04:33:12Z,article_selection,gpt-4.1-mini,1167,12,1179
2025-08-22T04:33:13Z,article_selection,gpt-4.1-mini,3200,16,3216
2025-08-22T04:33:13Z,article_selection,gpt-4.1-mini,539,9,548
2025-08-22T04:33:14Z,article_selection,gpt-4.1-mini,423,5,428
2025-08-22T04:33:31Z,final_summary_en,gpt-4.1-mini,1249,1283,2532
2025-08-22T04:33:46Z,final_summary_en,gpt-4.1-mini,1276,902,2178
2025-08-22T04:34:01Z,final_summary_en,gpt-4.1-mini,1321,1220,2541
2025-08-22T04:34:13Z,final_summary_en,gpt-4.1-mini,742,966,1708
2025-08-22T04:34:31Z,final_summary_en,gpt-4.1-mini,2127,1298,3425
2025-08-22T04:34:52Z,final_summary_en,gpt-4.1-mini,1601,1162,2763
2025-08-22T04:35:09Z,final_summary_en,gpt-4.1-mini,1076,1164,2240
2025-08-22T04:35:21Z,final_summary_en,gpt-4.1-mini,1143,1081,2224
2025-08-22T04:35:41Z,final_summary_en,gpt-4.1-mini,4901,1443,6344
2025-08-22T04:35:59Z,final_summary_en,gpt-4.1-mini,1439,1318,2757
2025-08-22T04:36:17Z,final_summary_en,gpt-4.1-mini,895,992,1887
2025-08-22T04:36:35Z,final_summary_en,gpt-4.1-mini,1588,1125,2713
2025-08-22T04:36:51Z,final_summary_en,gpt-4.1-mini,1853,1183,3036
2025-08-22T04:37:10Z,final_summary_en,gpt-4.1-mini,1552,1196,2748
2025-08-22T04:37:35Z,final_summary_en,gpt-4.1-mini,1063,1160,2223
2025-08-22T04:37:57Z,final_summary_en,gpt-4.1-mini,1198,1179,2377
2025-08-22T04:38:11Z,final_summary_en,gpt-4.1-mini,1191,959,2150
2025-08-22T04:38:26Z,final_summary_en,gpt-4.1-mini,1010,1112,2122
2025-08-22T04:39:30Z,category_summary,gpt-4.1-mini,138,29,167
2025-08-22T04:39:32Z,category_summary,gpt-4.1-mini,115,26,141
2025-08-22T04:39:34Z,category_summary,gpt-4.1-mini,94,20,114
2025-08-22T04:39:36Z,category_summary,gpt-4.1-mini,137,30,167
2025-08-22T04:39:38Z,category_summary,gpt-4.1-mini,130,33,163
2025-08-22T04:39:39Z,category_summary,gpt-4.1-mini,83,15,98
2025-08-22T04:39:40Z,RUN_TOTAL,,156143,29713,185856
2025-08-23T04:25:33Z,pre_sentiment,gpt-4.1-mini,285,1,286
2025-08-23T04:25:33Z,pre_sentiment,gpt-4.1-mini,286,1,287
2025-08-23T04:25:34Z,pre_sentiment,gpt-4.1-mini,279,1,280
2025-08-23T04:25:35Z,pre_sentiment,gpt-4.1-mini,288,1,289
2025-08-23T04:25:35Z,pre_sentiment,gpt-4.1-mini,287,1,288
2025-08-23T04:25:37Z,sentiment,gpt-4.1-mini,1492,171,1663
2025-08-23T04:25:38Z,pre_sentiment,gpt-4.1-mini,286,1,287
2025-08-23T04:25:39Z,pre_sentiment,gpt-4.1-mini,286,1,287
2025-08-23T04:25:39Z,pre_sentiment,gpt-4.1-mini,280,1,281
2025-08-23T04:25:40Z,pre_sentiment,gpt-4.1-mini,274,1,275
2025-08-23T04:25:40Z,pre_sentiment,gpt-4.1-mini,277,1,278
2025-08-23T04:25:40Z,pre_sentiment,gpt-4.1-mini,286,1,287
2025-08-23T04:25:41Z,pre_sentiment,gpt-4.1-mini,285,1,286
2025-08-23T04:25:43Z,sentiment,gpt-4.1-mini,1410,160,1570
2025-08-23T04:25:43Z,pre_sentiment,gpt-4.1-mini,287,1,288
2025-08-23T04:25:44Z,pre_sentiment,gpt-4.1-mini,287,1,288
2025-08-23T04:25:44Z,pre_sentiment,gpt-4.1-mini,286,1,287
2025-08-23T04:25:52Z,pre_sentiment,gpt-4.1-mini,281,1,282
2025-08-23T04:25:52Z,pre_sentiment,gpt-4.1-mini,281,1,282
2025-08-23T04:25:52Z,pre_sentiment,gpt-4.1-mini,284,1,285
2025-08-23T04:25:56Z,pre_sentiment,gpt-4.1-mini,281,1,282
2025-08-23T04:25:58Z,sentiment,gpt-4.1-mini,1278,156,1434
2025-08-23T04:26:10Z,pre_sentiment,gpt-4.1-mini,283,1,284
2025-08-23T04:26:13Z,sentiment,gpt-4.1-mini,1656,199,1855
2025-08-23T04:26:13Z,pre_sentiment,gpt-4.1-mini,283,1,284
2025-08-23T04:26:16Z,sentiment,gpt-4.1-mini,2048,199,2247
2025-08-23T04:26:16Z,pre_sentiment,gpt-4.1-mini,287,1,288
2025-08-23T04:26:16Z,pre_sentiment,gpt-4.1-mini,283,1,284
2025-08-23T04:26:20Z,sentiment,gpt-4.1-mini,1848,211,2059
2025-08-23T04:26:20Z,pre_sentiment,gpt-4.1-mini,283,1,284
2025-08-23T04:26:24Z,sentiment,gpt-4.1-mini,1461,196,1657
2025-08-23T04:26:24Z,pre_sentiment,gpt-4.1-mini,283,1,284
2025-08-23T04:26:26Z,sentiment,gpt-4.1-mini,1763,215,1978
2025-08-23T04:26:27Z,pre_sentiment,gpt-4.1-mini,280,1,281
2025-08-23T04:26:29Z,sentiment,gpt-4.1-mini,1499,217,1716
2025-08-23T04:26:45Z,pre_sentiment,gpt-4.1-mini,299,1,300
2025-08-23T04:26:48Z,sentiment,gpt-4.1-mini,916,100,1016
2025-08-23T04:26:48Z,pre_sentiment,gpt-4.1-mini,300,1,301
2025-08-23T04:26:49Z,pre_sentiment,gpt-4.1-mini,289,1,290
2025-08-23T04:26:51Z,sentiment,gpt-4.1-mini,1763,136,1899
2025-08-23T04:26:51Z,pre_sentiment,gpt-4.1-mini,303,1,304
2025-08-23T04:26:52Z,pre_sentiment,gpt-4.1-mini,298,1,299
2025-08-23T04:26:52Z,pre_sentiment,gpt-4.1-mini,295,1,296
2025-08-23T04:26:54Z,sentiment,gpt-4.1-mini,2567,211,2778
2025-08-23T04:26:55Z,pre_sentiment,gpt-4.1-mini,304,1,305
2025-08-23T04:26:56Z,sentiment,gpt-4.1-mini,1020,90,1110
2025-08-23T04:26:56Z,pre_sentiment,gpt-4.1-mini,296,1,297
2025-08-23T04:26:58Z,sentiment,gpt-4.1-mini,914,110,1024
2025-08-23T04:26:58Z,pre_sentiment,gpt-4.1-mini,306,1,307
2025-08-23T04:27:00Z,sentiment,gpt-4.1-mini,1519,190,1709
2025-08-23T04:27:01Z,pre_sentiment,gpt-4.1-mini,298,1,299
2025-08-23T04:27:01Z,pre_sentiment,gpt-4.1-mini,300,1,301
2025-08-23T04:27:03Z,sentiment,gpt-4.1-mini,1921,150,2071
2025-08-23T04:27:03Z,pre_sentiment,gpt-4.1-mini,302,1,303
2025-08-23T04:27:06Z,sentiment,gpt-4.1-mini,1599,170,1769
2025-08-23T04:27:06Z,pre_sentiment,gpt-4.1-mini,306,1,307
2025-08-23T04:27:09Z,sentiment,gpt-4.1-mini,1246,247,1493
2025-08-23T04:27:09Z,pre_sentiment,gpt-4.1-mini,301,1,302
2025-08-23T04:27:11Z,sentiment,gpt-4.1-mini,924,112,1036
2025-08-23T04:27:11Z,pre_sentiment,gpt-4.1-mini,296,1,297
2025-08-23T04:27:13Z,sentiment,gpt-4.1-mini,916,123,1039
2025-08-23T04:27:29Z,pre_sentiment,gpt-4.1-mini,280,1,281
2025-08-23T04:27:31Z,sentiment,gpt-4.1-mini,1314,192,1506
2025-08-23T04:27:31Z,pre_sentiment,gpt-4.1-mini,291,1,292
2025-08-23T04:27:33Z,sentiment,gpt-4.1-mini,886,116,1002
2025-08-23T04:27:33Z,pre_sentiment,gpt-4.1-mini,286,1,287
2025-08-23T04:27:35Z,sentiment,gpt-4.1-mini,1639,168,1807
2025-08-23T04:27:36Z,pre_sentiment,gpt-4.1-mini,282,1,283
2025-08-23T04:27:38Z,sentiment,gpt-4.1-mini,1011,176,1187
2025-08-23T04:27:38Z,pre_sentiment,gpt-4.1-mini,293,1,294
2025-08-23T04:27:40Z,sentiment,gpt-4.1-mini,2274,169,2443
2025-08-23T04:27:41Z,pre_sentiment,gpt-4.1-mini,275,1,276
2025-08-23T04:27:43Z,sentiment,gpt-4.1-mini,1692,200,1892
2025-08-23T04:27:43Z,pre_sentiment,gpt-4.1-mini,286,1,287
2025-08-23T04:27:45Z,sentiment,gpt-4.1-mini,1188,151,1339
2025-08-23T04:27:50Z,pre_sentiment,gpt-4.1-mini,284,1,285
2025-08-23T04:27:51Z,sentiment,gpt-4.1-mini,924,111,1035
2025-08-23T04:27:56Z,pre_sentiment,gpt-4.1-mini,271,1,272
2025-08-23T04:27:57Z,pre_sentiment,gpt-4.1-mini,257,1,258
2025-08-23T04:27:57Z,pre_sentiment,gpt-4.1-mini,287,1,288
2025-08-23T04:27:57Z,pre_sentiment,gpt-4.1-mini,262,1,263
2025-08-23T04:28:00Z,sentiment,gpt-4.1-mini,1920,223,2143
2025-08-23T04:28:11Z,pre_sentiment,gpt-4.1-mini,284,1,285
2025-08-23T04:28:13Z,sentiment,gpt-4.1-mini,1963,188,2151
2025-08-23T04:28:14Z,pre_sentiment,gpt-4.1-mini,284,1,285
2025-08-23T04:28:15Z,sentiment,gpt-4.1-mini,1441,184,1625
2025-08-23T04:28:16Z,pre_sentiment,gpt-4.1-mini,283,1,284
2025-08-23T04:28:19Z,sentiment,gpt-4.1-mini,1602,203,1805
2025-08-23T04:28:19Z,pre_sentiment,gpt-4.1-mini,281,1,282
2025-08-23T04:28:20Z,pre_sentiment,gpt-4.1-mini,280,1,281
2025-08-23T04:28:23Z,sentiment,gpt-4.1-mini,1932,239,2171
2025-08-23T04:30:48Z,pre_sentiment,gpt-4.1-mini,299,1,300
2025-08-23T04:30:51Z,sentiment,gpt-4.1-mini,5398,233,5631
2025-08-23T04:30:51Z,pre_sentiment,gpt-4.1-mini,288,1,289
2025-08-23T04:30:53Z,sentiment,gpt-4.1-mini,2295,126,2421
2025-08-23T04:31:08Z,pre_sentiment,gpt-4.1-mini,290,1,291
2025-08-23T04:31:08Z,pre_sentiment,gpt-4.1-mini,289,1,290
2025-08-23T04:31:09Z,pre_sentiment,gpt-4.1-mini,287,1,288
2025-08-23T04:31:11Z,sentiment,gpt-4.1-mini,1611,225,1836
2025-08-23T04:31:12Z,pre_sentiment,gpt-4.1-mini,282,1,283
2025-08-23T04:31:12Z,pre_sentiment,gpt-4.1-mini,290,1,291
2025-08-23T04:31:14Z,sentiment,gpt-4.1-mini,1229,141,1370
2025-08-23T04:31:14Z,pre_sentiment,gpt-4.1-mini,286,1,287
2025-08-23T04:31:27Z,pre_sentiment,gpt-4.1-mini,278,1,279
2025-08-23T04:31:28Z,pre_sentiment,gpt-4.1-mini,288,1,289
2025-08-23T04:31:30Z,sentiment,gpt-4.1-mini,1425,158,1583
2025-08-23T04:31:30Z,pre_sentiment,gpt-4.1-mini,286,1,287
2025-08-23T04:31:34Z,sentiment,gpt-4.1-mini,2259,228,2487
2025-08-23T04:31:34Z,pre_sentiment,gpt-4.1-mini,282,1,283
2025-08-23T04:31:47Z,pre_sentiment,gpt-4.1-mini,303,1,304
2025-08-23T04:31:47Z,pre_sentiment,gpt-4.1-mini,304,1,305
2025-08-23T04:31:50Z,sentiment,gpt-4.1-mini,1380,185,1565
2025-08-23T04:31:50Z,pre_sentiment,gpt-4.1-mini,287,1,288
2025-08-23T04:31:51Z,pre_sentiment,gpt-4.1-mini,293,1,294
2025-08-23T04:31:51Z,pre_sentiment,gpt-4.1-mini,281,1,282
2025-08-23T04:31:51Z,pre_sentiment,gpt-4.1-mini,291,1,292
2025-08-23T04:31:54Z,sentiment,gpt-4.1-mini,1469,183,1652
2025-08-23T04:31:54Z,pre_sentiment,gpt-4.1-mini,285,1,286
2025-08-23T04:31:57Z,sentiment,gpt-4.1-mini,1674,240,1914
2025-08-23T04:31:57Z,pre_sentiment,gpt-4.1-mini,288,1,289
2025-08-23T04:31:58Z,pre_sentiment,gpt-4.1-mini,284,1,285
2025-08-23T04:32:00Z,sentiment,gpt-4.1-mini,3469,215,3684
2025-08-23T04:32:08Z,article_selection,gpt-4.1-mini,1211,12,1223
2025-08-23T04:32:09Z,article_selection,gpt-4.1-mini,608,9,617
2025-08-23T04:32:09Z,article_selection,gpt-4.1-mini,1060,12,1072
2025-08-23T04:32:10Z,article_selection,gpt-4.1-mini,507,13,520
2025-08-23T04:32:10Z,article_selection,gpt-4.1-mini,620,6,626
2025-08-23T04:32:24Z,final_summary_en,gpt-4.1-mini,1401,1110,2511
2025-08-23T04:32:37Z,final_summary_en,gpt-4.1-mini,1203,1123,2326
2025-08-23T04:32:51Z,final_summary_en,gpt-4.1-mini,1512,1160,2672
2025-08-23T04:33:05Z,final_summary_en,gpt-4.1-mini,1197,1087,2284
2025-08-23T04:33:20Z,final_summary_en,gpt-4.1-mini,1803,1180,2983
2025-08-23T04:33:38Z,final_summary_en,gpt-4.1-mini,1444,1120,2564
2025-08-23T04:33:51Z,final_summary_en,gpt-4.1-mini,751,985,1736
2025-08-23T04:34:06Z,final_summary_en,gpt-4.1-mini,1610,1216,2826
2025-08-23T04:34:19Z,final_summary_en,gpt-4.1-mini,1268,1002,2270
2025-08-23T04:34:34Z,final_summary_en,gpt-4.1-mini,5165,1054,6219
2025-08-23T04:34:46Z,final_summary_en,gpt-4.1-mini,1061,934,1995
2025-08-23T04:35:00Z,final_summary_en,gpt-4.1-mini,2344,1194,3538
2025-08-23T04:35:14Z,final_summary_en,gpt-4.1-mini,1690,1183,2873
2025-08-23T04:35:32Z,final_summary_en,gpt-4.1-mini,1373,1219,2592
2025-08-23T04:35:46Z,final_summary_en,gpt-4.1-mini,2019,1171,3190
2025-08-23T04:35:58Z,final_summary_en,gpt-4.1-mini,1129,957,2086
2025-08-23T04:36:14Z,final_summary_en,gpt-4.1-mini,3230,1189,4419
2025-08-23T04:37:10Z,category_summary,gpt-4.1-mini,131,40,171
2025-08-23T04:37:13Z,category_summary,gpt-4.1-mini,113,27,140
2025-08-23T04:37:15Z,category_summary,gpt-4.1-mini,137,33,170
2025-08-23T04:37:16Z,category_summary,gpt-4.1-mini,116,33,149
2025-08-23T04:37:18Z,category_summary,gpt-4.1-mini,103,33,136
2025-08-23T04:37:20Z,category_summary,gpt-4.1-mini,86,15,101
2025-08-23T04:37:21Z,RUN_TOTAL,,129335,26813,156148
2025-08-24T04:28:09Z,pre_sentiment,gpt-4.1-mini,278,1,279
2025-08-24T04:28:12Z,sentiment,gpt-4.1-mini,1335,196,1531
2025-08-24T04:28:13Z,pre_sentiment,gpt-4.1-mini,289,1,290
2025-08-24T04:28:15Z,sentiment,gpt-4.1-mini,2435,171,2606
2025-08-24T04:28:16Z,pre_sentiment,gpt-4.1-mini,277,1,278
2025-08-24T04:28:16Z,pre_sentiment,gpt-4.1-mini,296,1,297
2025-08-24T04:28:17Z,pre_sentiment,gpt-4.1-mini,287,1,288
2025-08-24T04:28:17Z,pre_sentiment,gpt-4.1-mini,284,1,285
2025-08-24T04:28:18Z,pre_sentiment,gpt-4.1-mini,283,1,284
2025-08-24T04:28:18Z,pre_sentiment,gpt-4.1-mini,281,1,282
2025-08-24T04:28:19Z,pre_sentiment,gpt-4.1-mini,297,1,298
2025-08-24T04:28:19Z,pre_sentiment,gpt-4.1-mini,290,1,291
2025-08-24T04:28:19Z,pre_sentiment,gpt-4.1-mini,286,1,287
2025-08-24T04:28:20Z,pre_sentiment,gpt-4.1-mini,287,1,288
2025-08-24T04:28:26Z,sentiment,gpt-4.1-mini,1668,175,1843
2025-08-24T04:28:26Z,pre_sentiment,gpt-4.1-mini,280,1,281
2025-08-24T04:28:27Z,pre_sentiment,gpt-4.1-mini,284,1,285
2025-08-24T04:28:27Z,pre_sentiment,gpt-4.1-mini,288,1,289
2025-08-24T04:28:33Z,pre_sentiment,gpt-4.1-mini,292,1,293
2025-08-24T04:28:38Z,pre_sentiment,gpt-4.1-mini,297,1,298
2025-08-24T04:28:46Z,pre_sentiment,gpt-4.1-mini,278,1,279
2025-08-24T04:28:49Z,sentiment,gpt-4.1-mini,1972,199,2171
2025-08-24T04:28:49Z,pre_sentiment,gpt-4.1-mini,278,1,279
2025-08-24T04:28:50Z,pre_sentiment,gpt-4.1-mini,283,1,284
2025-08-24T04:28:52Z,sentiment,gpt-4.1-mini,1709,203,1912
2025-08-24T04:28:53Z,pre_sentiment,gpt-4.1-mini,281,1,282
2025-08-24T04:28:56Z,sentiment,gpt-4.1-mini,1718,191,1909
2025-08-24T04:28:56Z,pre_sentiment,gpt-4.1-mini,279,1,280
2025-08-24T04:28:59Z,sentiment,gpt-4.1-mini,1650,183,1833
2025-08-24T04:29:00Z,pre_sentiment,gpt-4.1-mini,280,1,281
2025-08-24T04:29:03Z,sentiment,gpt-4.1-mini,1365,214,1579
2025-08-24T04:29:03Z,pre_sentiment,gpt-4.1-mini,283,1,284
2025-08-24T04:29:07Z,sentiment,gpt-4.1-mini,2210,237,2447
2025-08-24T04:29:07Z,pre_sentiment,gpt-4.1-mini,282,1,283
2025-08-24T04:29:09Z,sentiment,gpt-4.1-mini,1790,179,1969
2025-08-24T04:29:10Z,pre_sentiment,gpt-4.1-mini,279,1,280
2025-08-24T04:29:11Z,sentiment,gpt-4.1-mini,2056,172,2228
2025-08-24T04:29:12Z,pre_sentiment,gpt-4.1-mini,278,1,279
2025-08-24T04:29:17Z,sentiment,gpt-4.1-mini,2211,245,2456
2025-08-24T04:29:31Z,pre_sentiment,gpt-4.1-mini,299,1,300
2025-08-24T04:29:33Z,sentiment,gpt-4.1-mini,916,115,1031
2025-08-24T04:29:33Z,pre_sentiment,gpt-4.1-mini,300,1,301
2025-08-24T04:29:33Z,pre_sentiment,gpt-4.1-mini,289,1,290
2025-08-24T04:29:35Z,sentiment,gpt-4.1-mini,1763,122,1885
2025-08-24T04:29:35Z,pre_sentiment,gpt-4.1-mini,303,1,304
2025-08-24T04:29:35Z,pre_sentiment,gpt-4.1-mini,298,1,299
2025-08-24T04:29:36Z,pre_sentiment,gpt-4.1-mini,304,1,305
2025-08-24T04:29:37Z,sentiment,gpt-4.1-mini,1020,97,1117
2025-08-24T04:29:38Z,pre_sentiment,gpt-4.1-mini,296,1,297
2025-08-24T04:29:40Z,sentiment,gpt-4.1-mini,914,114,1028
2025-08-24T04:29:40Z,pre_sentiment,gpt-4.1-mini,306,1,307
2025-08-24T04:29:42Z,sentiment,gpt-4.1-mini,1519,203,1722
2025-08-24T04:29:43Z,pre_sentiment,gpt-4.1-mini,298,1,299
2025-08-24T04:29:43Z,pre_sentiment,gpt-4.1-mini,300,1,301
2025-08-24T04:29:45Z,sentiment,gpt-4.1-mini,1921,165,2086
2025-08-24T04:29:46Z,pre_sentiment,gpt-4.1-mini,302,1,303
2025-08-24T04:29:48Z,sentiment,gpt-4.1-mini,1599,181,1780
2025-08-24T04:29:49Z,pre_sentiment,gpt-4.1-mini,306,1,307
2025-08-24T04:29:51Z,sentiment,gpt-4.1-mini,1246,216,1462
2025-08-24T04:29:51Z,pre_sentiment,gpt-4.1-mini,301,1,302
2025-08-24T04:29:53Z,sentiment,gpt-4.1-mini,924,94,1018
2025-08-24T04:29:53Z,pre_sentiment,gpt-4.1-mini,296,1,297
2025-08-24T04:29:54Z,sentiment,gpt-4.1-mini,916,90,1006
2025-08-24T04:30:21Z,pre_sentiment,gpt-4.1-mini,276,1,277
2025-08-24T04:30:36Z,pre_sentiment,gpt-4.1-mini,286,1,287
2025-08-24T04:30:44Z,pre_sentiment,gpt-4.1-mini,286,1,287
2025-08-24T04:33:42Z,pre_sentiment,gpt-4.1-mini,286,1,287
2025-08-24T04:33:55Z,pre_sentiment,gpt-4.1-mini,274,1,275
2025-08-24T04:33:56Z,pre_sentiment,gpt-4.1-mini,290,1,291
2025-08-24T04:33:56Z,pre_sentiment,gpt-4.1-mini,278,1,279
2025-08-24T04:34:17Z,article_selection,gpt-4.1-mini,782,12,794
2025-08-24T04:34:17Z,article_selection,gpt-4.1-mini,771,9,780
2025-08-24T04:34:18Z,article_selection,gpt-4.1-mini,495,5,500
2025-08-24T04:34:30Z,final_summary_en,gpt-4.1-mini,1980,1133,3113
2025-08-24T04:34:43Z,final_summary_en,gpt-4.1-mini,1729,1152,2881
2025-08-24T04:34:54Z,final_summary_en,gpt-4.1-mini,1455,1153,2608
2025-08-24T04:35:10Z,final_summary_en,gpt-4.1-mini,1389,1147,2536
2025-08-24T04:35:23Z,final_summary_en,gpt-4.1-mini,1133,1128,2261
2025-08-24T04:35:41Z,final_summary_en,gpt-4.1-mini,1465,1159,2624
2025-08-24T04:35:53Z,final_summary_en,gpt-4.1-mini,1281,1110,2391
2025-08-24T04:36:07Z,final_summary_en,gpt-4.1-mini,1006,1178,2184
2025-08-24T04:36:21Z,final_summary_en,gpt-4.1-mini,1346,1279,2625
2025-08-24T04:36:34Z,final_summary_en,gpt-4.1-mini,1785,1219,3004
2025-08-24T04:36:46Z,final_summary_en,gpt-4.1-mini,1999,1139,3138
2025-08-24T04:36:58Z,final_summary_en,gpt-4.1-mini,1093,1004,2097
2025-08-24T04:37:36Z,category_summary,gpt-4.1-mini,148,44,192
2025-08-24T04:37:38Z,category_summary,gpt-4.1-mini,88,18,106
2025-08-24T04:37:39Z,category_summary,gpt-4.1-mini,120,28,148
2025-08-24T04:37:41Z,category_summary,gpt-4.1-mini,82,19,101
2025-08-24T04:37:43Z,category_summary,gpt-4.1-mini,97,23,120
2025-08-24T04:37:44Z,RUN_TOTAL,,68952,17769,86721
2025-08-25T04:29:17Z,pre_sentiment,gpt-4.1-mini,281,1,282
2025-08-25T04:29:18Z,pre_sentiment,gpt-4.1-mini,287,1,288
2025-08-25T04:29:19Z,pre_sentiment,gpt-4.1-mini,280,1,281
2025-08-25T04:29:21Z,sentiment,gpt-4.1-mini,1915,194,2109
2025-08-25T04:29:21Z,pre_sentiment,gpt-4.1-mini,281,1,282
2025-08-25T04:29:22Z,pre_sentiment,gpt-4.1-mini,282,1,283
2025-08-25T04:29:22Z,pre_sentiment,gpt-4.1-mini,288,1,289
2025-08-25T04:29:22Z,pre_sentiment,gpt-4.1-mini,281,1,282
2025-08-25T04:29:24Z,sentiment,gpt-4.1-mini,1336,111,1447
2025-08-25T04:29:25Z,pre_sentiment,gpt-4.1-mini,280,1,281
2025-08-25T04:29:25Z,pre_sentiment,gpt-4.1-mini,291,1,292
2025-08-25T04:29:28Z,sentiment,gpt-4.1-mini,1978,194,2172
2025-08-25T04:29:29Z,pre_sentiment,gpt-4.1-mini,284,1,285
2025-08-25T04:29:30Z,pre_sentiment,gpt-4.1-mini,278,1,279
2025-08-25T04:29:31Z,sentiment,gpt-4.1-mini,936,120,1056
2025-08-25T04:29:32Z,pre_sentiment,gpt-4.1-mini,286,1,287
2025-08-25T04:29:32Z,pre_sentiment,gpt-4.1-mini,285,1,286
2025-08-25T04:29:32Z,pre_sentiment,gpt-4.1-mini,285,1,286
2025-08-25T04:29:49Z,pre_sentiment,gpt-4.1-mini,286,1,287
2025-08-25T04:29:52Z,sentiment,gpt-4.1-mini,1417,174,1591
2025-08-25T04:29:52Z,pre_sentiment,gpt-4.1-mini,288,1,289
2025-08-25T04:29:55Z,sentiment,gpt-4.1-mini,1413,205,1618
2025-08-25T04:29:55Z,pre_sentiment,gpt-4.1-mini,283,1,284
2025-08-25T04:29:57Z,sentiment,gpt-4.1-mini,1470,181,1651
2025-08-25T04:29:58Z,pre_sentiment,gpt-4.1-mini,286,1,287
2025-08-25T04:30:01Z,sentiment,gpt-4.1-mini,1843,216,2059
2025-08-25T04:30:01Z,pre_sentiment,gpt-4.1-mini,280,1,281
2025-08-25T04:30:04Z,sentiment,gpt-4.1-mini,1727,177,1904
2025-08-25T04:30:04Z,pre_sentiment,gpt-4.1-mini,275,1,276
2025-08-25T04:30:04Z,pre_sentiment,gpt-4.1-mini,285,1,286
2025-08-25T04:30:08Z,sentiment,gpt-4.1-mini,2535,224,2759
2025-08-25T04:30:08Z,pre_sentiment,gpt-4.1-mini,279,1,280
2025-08-25T04:30:11Z,sentiment,gpt-4.1-mini,2082,216,2298
2025-08-25T04:30:12Z,pre_sentiment,gpt-4.1-mini,277,1,278
2025-08-25T04:30:14Z,sentiment,gpt-4.1-mini,1510,223,1733
2025-08-25T04:30:15Z,pre_sentiment,gpt-4.1-mini,285,1,286
2025-08-25T04:30:18Z,sentiment,gpt-4.1-mini,2048,216,2264
2025-08-25T04:30:18Z,pre_sentiment,gpt-4.1-mini,278,1,279
2025-08-25T04:30:33Z,pre_sentiment,gpt-4.1-mini,299,1,300
2025-08-25T04:30:35Z,sentiment,gpt-4.1-mini,916,114,1030
2025-08-25T04:30:35Z,pre_sentiment,gpt-4.1-mini,300,1,301
2025-08-25T04:30:35Z,pre_sentiment,gpt-4.1-mini,289,1,290
2025-08-25T04:30:36Z,pre_sentiment,gpt-4.1-mini,303,1,304
2025-08-25T04:30:36Z,pre_sentiment,gpt-4.1-mini,298,1,299
2025-08-25T04:30:36Z,pre_sentiment,gpt-4.1-mini,304,1,305
2025-08-25T04:30:38Z,sentiment,gpt-4.1-mini,1020,89,1109
2025-08-25T04:30:38Z,pre_sentiment,gpt-4.1-mini,296,1,297
2025-08-25T04:30:40Z,sentiment,gpt-4.1-mini,914,106,1020
2025-08-25T04:30:41Z,pre_sentiment,gpt-4.1-mini,298,1,299
2025-08-25T04:30:41Z,pre_sentiment,gpt-4.1-mini,300,1,301
2025-08-25T04:30:44Z,sentiment,gpt-4.1-mini,1921,160,2081
2025-08-25T04:30:45Z,pre_sentiment,gpt-4.1-mini,301,1,302
2025-08-25T04:30:47Z,sentiment,gpt-4.1-mini,924,130,1054
2025-08-25T04:30:47Z,pre_sentiment,gpt-4.1-mini,296,1,297
2025-08-25T04:30:49Z,sentiment,gpt-4.1-mini,916,94,1010
2025-08-25T04:31:04Z,pre_sentiment,gpt-4.1-mini,289,1,290
2025-08-25T04:31:07Z,sentiment,gpt-4.1-mini,1625,251,1876
2025-08-25T04:31:17Z,pre_sentiment,gpt-4.1-mini,262,1,263
2025-08-25T04:32:17Z,pre_sentiment,gpt-4.1-mini,287,1,288
2025-08-25T04:32:19Z,sentiment,gpt-4.1-mini,1592,182,1774
2025-08-25T04:32:32Z,pre_sentiment,gpt-4.1-mini,285,1,286
2025-08-25T04:32:32Z,pre_sentiment,gpt-4.1-mini,284,1,285
2025-08-25T04:32:35Z,sentiment,gpt-4.1-mini,2589,217,2806
2025-08-25T04:32:35Z,pre_sentiment,gpt-4.1-mini,274,1,275
2025-08-25T04:32:48Z,pre_sentiment,gpt-4.1-mini,293,1,294
2025-08-25T04:33:00Z,article_selection,gpt-4.1-mini,814,12,826
2025-08-25T04:33:01Z,article_selection,gpt-4.1-mini,475,13,488
2025-08-25T04:33:01Z,article_selection,gpt-4.1-mini,543,9,552
2025-08-25T04:33:02Z,article_selection,gpt-4.1-mini,475,6,481
2025-08-25T04:33:18Z,final_summary_en,gpt-4.1-mini,1212,1197,2409
2025-08-25T04:33:30Z,final_summary_en,gpt-4.1-mini,1817,1088,2905
2025-08-25T04:33:43Z,final_summary_en,gpt-4.1-mini,1606,1013,2619
2025-08-25T04:33:59Z,final_summary_en,gpt-4.1-mini,1468,1020,2488
2025-08-25T04:34:19Z,final_summary_en,gpt-4.1-mini,1339,1068,2407
2025-08-25T04:34:35Z,final_summary_en,gpt-4.1-mini,2340,1133,3473
2025-08-25T04:34:51Z,final_summary_en,gpt-4.1-mini,1674,1137,2811
2025-08-25T04:35:07Z,final_summary_en,gpt-4.1-mini,1732,1046,2778
2025-08-25T04:35:23Z,final_summary_en,gpt-4.1-mini,1184,1001,2185
2025-08-25T04:35:38Z,final_summary_en,gpt-4.1-mini,2285,1094,3379
2025-08-25T04:35:53Z,final_summary_en,gpt-4.1-mini,1842,1239,3081
2025-08-25T04:36:10Z,final_summary_en,gpt-4.1-mini,1394,1255,2649
2025-08-25T04:36:23Z,final_summary_en,gpt-4.1-mini,1161,1157,2318
2025-08-25T04:37:25Z,category_summary,gpt-4.1-mini,132,29,161
2025-08-25T04:37:26Z,category_summary,gpt-4.1-mini,86,25,111
2025-08-25T04:37:28Z,category_summary,gpt-4.1-mini,112,36,148
2025-08-25T04:37:30Z,category_summary,gpt-4.1-mini,129,34,163
2025-08-25T04:37:32Z,category_summary,gpt-4.1-mini,106,37,143
2025-08-25T04:37:33Z,RUN_TOTAL,,70882,18486,89368
2025-08-26T04:26:25Z,pre_sentiment,gpt-4.1-mini,279,1,280
2025-08-26T04:26:25Z,pre_sentiment,gpt-4.1-mini,280,1,281
2025-08-26T04:26:26Z,pre_sentiment,gpt-4.1-mini,281,1,282
2025-08-26T04:26:26Z,pre_sentiment,gpt-4.1-mini,285,1,286
2025-08-26T04:26:26Z,pre_sentiment,gpt-4.1-mini,284,1,285
2025-08-26T04:26:28Z,pre_sentiment,gpt-4.1-mini,286,1,287
2025-08-26T04:26:28Z,pre_sentiment,gpt-4.1-mini,285,1,286
2025-08-26T04:26:30Z,pre_sentiment,gpt-4.1-mini,286,1,287
2025-08-26T04:26:30Z,pre_sentiment,gpt-4.1-mini,276,1,277
2025-08-26T04:26:40Z,sentiment,gpt-4.1-mini,1336,211,1547
2025-08-26T04:26:40Z,pre_sentiment,gpt-4.1-mini,288,1,289
2025-08-26T04:26:42Z,sentiment,gpt-4.1-mini,1664,171,1835
2025-08-26T04:26:43Z,pre_sentiment,gpt-4.1-mini,288,1,289
2025-08-26T04:26:43Z,pre_sentiment,gpt-4.1-mini,292,1,293
2025-08-26T04:26:43Z,pre_sentiment,gpt-4.1-mini,279,1,280
2025-08-26T04:26:47Z,sentiment,gpt-4.1-mini,2075,206,2281
2025-08-26T04:26:47Z,pre_sentiment,gpt-4.1-mini,287,1,288
2025-08-26T04:27:00Z,pre_sentiment,gpt-4.1-mini,282,1,283
2025-08-26T04:27:00Z,pre_sentiment,gpt-4.1-mini,281,1,282
2025-08-26T04:27:11Z,pre_sentiment,gpt-4.1-mini,281,1,282
2025-08-26T04:27:18Z,pre_sentiment,gpt-4.1-mini,287,1,288
2025-08-26T04:27:18Z,pre_sentiment,gpt-4.1-mini,282,1,283
2025-08-26T04:27:20Z,sentiment,gpt-4.1-mini,1793,186,1979
2025-08-26T04:27:20Z,pre_sentiment,gpt-4.1-mini,282,1,283
2025-08-26T04:27:22Z,sentiment,gpt-4.1-mini,1549,165,1714
2025-08-26T04:27:23Z,pre_sentiment,gpt-4.1-mini,289,1,290
2025-08-26T04:27:25Z,sentiment,gpt-4.1-mini,2006,207,2213
2025-08-26T04:27:26Z,pre_sentiment,gpt-4.1-mini,287,1,288
2025-08-26T04:27:28Z,sentiment,gpt-4.1-mini,1750,196,1946
2025-08-26T04:27:28Z,pre_sentiment,gpt-4.1-mini,281,1,282
2025-08-26T04:27:31Z,sentiment,gpt-4.1-mini,1356,184,1540
2025-08-26T04:27:31Z,pre_sentiment,gpt-4.1-mini,279,1,280
2025-08-26T04:27:33Z,sentiment,gpt-4.1-mini,1224,203,1427
2025-08-26T04:27:34Z,pre_sentiment,gpt-4.1-mini,283,1,284
2025-08-26T04:27:36Z,sentiment,gpt-4.1-mini,1363,170,1533
2025-08-26T04:27:36Z,pre_sentiment,gpt-4.1-mini,277,1,278
2025-08-26T04:27:38Z,sentiment,gpt-4.1-mini,1157,175,1332
2025-08-26T04:27:38Z,pre_sentiment,gpt-4.1-mini,282,1,283
2025-08-26T04:27:41Z,sentiment,gpt-4.1-mini,1387,190,1577
2025-08-26T04:27:41Z,pre_sentiment,gpt-4.1-mini,282,1,283
2025-08-26T04:27:44Z,sentiment,gpt-4.1-mini,1603,208,1811
2025-08-26T04:27:44Z,pre_sentiment,gpt-4.1-mini,282,1,283
2025-08-26T04:27:46Z,sentiment,gpt-4.1-mini,1347,185,1532
2025-08-26T04:28:00Z,pre_sentiment,gpt-4.1-mini,302,1,303
2025-08-26T04:28:02Z,sentiment,gpt-4.1-mini,1077,162,1239
2025-08-26T04:28:02Z,pre_sentiment,gpt-4.1-mini,294,1,295
2025-08-26T04:28:06Z,sentiment,gpt-4.1-mini,3125,271,3396
2025-08-26T04:28:07Z,pre_sentiment,gpt-4.1-mini,300,1,301
2025-08-26T04:28:13Z,sentiment,gpt-4.1-mini,1777,191,1968
2025-08-26T04:28:13Z,pre_sentiment,gpt-4.1-mini,299,1,300
2025-08-26T04:28:17Z,sentiment,gpt-4.1-mini,916,115,1031
2025-08-26T04:28:17Z,pre_sentiment,gpt-4.1-mini,300,1,301
2025-08-26T04:28:17Z,pre_sentiment,gpt-4.1-mini,289,1,290
2025-08-26T04:28:20Z,sentiment,gpt-4.1-mini,1763,113,1876
2025-08-26T04:28:20Z,pre_sentiment,gpt-4.1-mini,303,1,304
2025-08-26T04:28:20Z,pre_sentiment,gpt-4.1-mini,298,1,299
2025-08-26T04:28:20Z,pre_sentiment,gpt-4.1-mini,304,1,305
2025-08-26T04:28:22Z,sentiment,gpt-4.1-mini,1020,116,1136
2025-08-26T04:28:23Z,pre_sentiment,gpt-4.1-mini,296,1,297
2025-08-26T04:28:24Z,sentiment,gpt-4.1-mini,914,110,1024
2025-08-26T04:28:25Z,pre_sentiment,gpt-4.1-mini,298,1,299
2025-08-26T04:28:25Z,pre_sentiment,gpt-4.1-mini,300,1,301
2025-08-26T04:28:44Z,pre_sentiment,gpt-4.1-mini,285,1,286
2025-08-26T04:28:47Z,sentiment,gpt-4.1-mini,2023,191,2214
2025-08-26T04:28:47Z,pre_sentiment,gpt-4.1-mini,281,1,282
2025-08-26T04:28:49Z,sentiment,gpt-4.1-mini,1072,160,1232
2025-08-26T04:28:50Z,pre_sentiment,gpt-4.1-mini,281,1,282
2025-08-26T04:28:52Z,sentiment,gpt-4.1-mini,1849,154,2003
2025-08-26T04:28:52Z,pre_sentiment,gpt-4.1-mini,290,1,291
2025-08-26T04:28:55Z,sentiment,gpt-4.1-mini,2107,192,2299
2025-08-26T04:28:56Z,pre_sentiment,gpt-4.1-mini,286,1,287
2025-08-26T04:29:00Z,sentiment,gpt-4.1-mini,1538,147,1685
2025-08-26T04:29:00Z,pre_sentiment,gpt-4.1-mini,288,1,289
2025-08-26T04:29:03Z,sentiment,gpt-4.1-mini,3887,241,4128
2025-08-26T04:29:04Z,pre_sentiment,gpt-4.1-mini,260,1,261
2025-08-26T04:29:05Z,sentiment,gpt-4.1-mini,835,92,927
2025-08-26T04:29:05Z,pre_sentiment,gpt-4.1-mini,284,1,285
2025-08-26T04:29:08Z,sentiment,gpt-4.1-mini,1496,184,1680
2025-08-26T04:29:11Z,pre_sentiment,gpt-4.1-mini,294,1,295
2025-08-26T04:29:13Z,sentiment,gpt-4.1-mini,2059,143,2202
2025-08-26T04:29:13Z,pre_sentiment,gpt-4.1-mini,282,1,283
2025-08-26T04:29:16Z,sentiment,gpt-4.1-mini,1843,191,2034
2025-08-26T04:29:33Z,pre_sentiment,gpt-4.1-mini,292,1,293
2025-08-26T04:29:38Z,pre_sentiment,gpt-4.1-mini,279,1,280
2025-08-26T04:29:44Z,pre_sentiment,gpt-4.1-mini,283,1,284
2025-08-26T04:29:47Z,sentiment,gpt-4.1-mini,1610,210,1820
2025-08-26T04:29:47Z,pre_sentiment,gpt-4.1-mini,281,1,282
2025-08-26T04:29:50Z,sentiment,gpt-4.1-mini,1593,190,1783
2025-08-26T04:29:50Z,pre_sentiment,gpt-4.1-mini,287,1,288
2025-08-26T04:29:53Z,sentiment,gpt-4.1-mini,1612,182,1794
2025-08-26T04:29:54Z,pre_sentiment,gpt-4.1-mini,285,1,286
2025-08-26T04:29:57Z,sentiment,gpt-4.1-mini,3937,205,4142
2025-08-26T04:29:57Z,pre_sentiment,gpt-4.1-mini,277,1,278
2025-08-26T04:29:57Z,pre_sentiment,gpt-4.1-mini,287,1,288
2025-08-26T04:29:58Z,pre_sentiment,gpt-4.1-mini,288,1,289
2025-08-26T04:30:01Z,sentiment,gpt-4.1-mini,4307,224,4531
2025-08-26T04:30:12Z,pre_sentiment,gpt-4.1-mini,287,1,288
2025-08-26T04:30:12Z,pre_sentiment,gpt-4.1-mini,279,1,280
2025-08-26T04:30:14Z,sentiment,gpt-4.1-mini,1093,189,1282
2025-08-26T04:30:25Z,pre_sentiment,gpt-4.1-mini,291,1,292
2025-08-26T04:30:26Z,sentiment,gpt-4.1-mini,1225,115,1340
2025-08-26T04:30:31Z,pre_sentiment,gpt-4.1-mini,287,1,288
2025-08-26T04:31:09Z,pre_sentiment,gpt-4.1-mini,291,1,292
2025-08-26T04:31:11Z,sentiment,gpt-4.1-mini,1767,191,1958
2025-08-26T04:31:11Z,pre_sentiment,gpt-4.1-mini,285,1,286
2025-08-26T04:31:13Z,sentiment,gpt-4.1-mini,1776,192,1968
2025-08-26T04:31:13Z,pre_sentiment,gpt-4.1-mini,288,1,289
2025-08-26T04:31:15Z,sentiment,gpt-4.1-mini,1743,143,1886
2025-08-26T04:31:16Z,pre_sentiment,gpt-4.1-mini,300,1,301
2025-08-26T04:31:18Z,sentiment,gpt-4.1-mini,1583,204,1787
2025-08-26T04:31:32Z,pre_sentiment,gpt-4.1-mini,286,1,287
2025-08-26T04:31:33Z,pre_sentiment,gpt-4.1-mini,283,1,284
2025-08-26T04:31:36Z,sentiment,gpt-4.1-mini,1173,192,1365
2025-08-26T04:31:36Z,pre_sentiment,gpt-4.1-mini,287,1,288
2025-08-26T04:31:36Z,pre_sentiment,gpt-4.1-mini,285,1,286
2025-08-26T04:31:39Z,sentiment,gpt-4.1-mini,2386,198,2584
2025-08-26T04:31:51Z,pre_sentiment,gpt-4.1-mini,279,1,280
2025-08-26T04:31:54Z,sentiment,gpt-4.1-mini,2121,189,2310
2025-08-26T04:31:55Z,pre_sentiment,gpt-4.1-mini,285,1,286
2025-08-26T04:32:06Z,pre_sentiment,gpt-4.1-mini,291,1,292
2025-08-26T04:32:08Z,sentiment,gpt-4.1-mini,1156,158,1314
2025-08-26T04:32:09Z,pre_sentiment,gpt-4.1-mini,287,1,288
2025-08-26T04:32:11Z,sentiment,gpt-4.1-mini,1169,162,1331
2025-08-26T04:32:11Z,pre_sentiment,gpt-4.1-mini,291,1,292
2025-08-26T04:32:11Z,pre_sentiment,gpt-4.1-mini,306,1,307
2025-08-26T04:32:13Z,sentiment,gpt-4.1-mini,1257,141,1398
2025-08-26T04:32:14Z,pre_sentiment,gpt-4.1-mini,285,1,286
2025-08-26T04:32:14Z,pre_sentiment,gpt-4.1-mini,285,1,286
2025-08-26T04:32:17Z,sentiment,gpt-4.1-mini,1239,205,1444
2025-08-26T04:32:29Z,article_selection,gpt-4.1-mini,1269,9,1278
2025-08-26T04:32:29Z,article_selection,gpt-4.1-mini,797,12,809
2025-08-26T04:32:30Z,article_selection,gpt-4.1-mini,1139,9,1148
2025-08-26T04:32:30Z,article_selection,gpt-4.1-mini,1420,12,1432
2025-08-26T04:32:31Z,article_selection,gpt-4.1-mini,735,12,747
2025-08-26T04:32:54Z,final_summary_en,gpt-4.1-mini,3660,1537,5197
2025-08-26T04:33:11Z,final_summary_en,gpt-4.1-mini,2898,1274,4172
2025-08-26T04:33:25Z,final_summary_en,gpt-4.1-mini,1584,1049,2633
2025-08-26T04:33:39Z,final_summary_en,gpt-4.1-mini,1370,1125,2495
2025-08-26T04:33:56Z,final_summary_en,gpt-4.1-mini,1753,1292,3045
2025-08-26T04:34:11Z,final_summary_en,gpt-4.1-mini,1499,1174,2673
2025-08-26T04:34:27Z,final_summary_en,gpt-4.1-mini,1782,1022,2804
2025-08-26T04:34:45Z,final_summary_en,gpt-4.1-mini,1869,1281,3150
2025-08-26T04:35:01Z,final_summary_en,gpt-4.1-mini,1236,1081,2317
2025-08-26T04:35:17Z,final_summary_en,gpt-4.1-mini,1102,1124,2226
2025-08-26T04:35:32Z,final_summary_en,gpt-4.1-mini,1365,1250,2615
2025-08-26T04:35:43Z,final_summary_en,gpt-4.1-mini,1332,902,2234
2025-08-26T04:36:11Z,final_summary_en,gpt-4.1-mini,3682,1433,5115
2025-08-26T04:36:29Z,final_summary_en,gpt-4.1-mini,4070,1201,5271
2025-08-26T04:36:46Z,final_summary_en,gpt-4.1-mini,1283,1110,2393
2025-08-26T04:37:03Z,final_summary_en,gpt-4.1-mini,1084,1071,2155
2025-08-26T04:37:18Z,final_summary_en,gpt-4.1-mini,2154,1092,3246
2025-08-26T04:37:34Z,final_summary_en,gpt-4.1-mini,1322,1247,2569
2025-08-26T04:37:48Z,final_summary_en,gpt-4.1-mini,1090,1061,2151
2025-08-26T04:38:02Z,final_summary_en,gpt-4.1-mini,1825,1004,2829
2025-08-26T04:38:20Z,final_summary_en,gpt-4.1-mini,1867,1093,2960
2025-08-26T04:38:34Z,final_summary_en,gpt-4.1-mini,892,841,1733
2025-08-26T04:40:01Z,category_summary,gpt-4.1-mini,125,36,161
2025-08-26T04:40:04Z,category_summary,gpt-4.1-mini,119,34,153
2025-08-26T04:40:05Z,category_summary,gpt-4.1-mini,133,30,163
2025-08-26T04:40:07Z,category_summary,gpt-4.1-mini,133,33,166
2025-08-26T04:40:09Z,category_summary,gpt-4.1-mini,142,37,179
2025-08-26T04:40:11Z,category_summary,gpt-4.1-mini,95,24,119
2025-08-26T04:40:12Z,RUN_TOTAL,,153428,34312,187740
2025-08-27T04:26:15Z,pre_sentiment,gpt-4.1-mini,282,1,283
2025-08-27T04:26:15Z,pre_sentiment,gpt-4.1-mini,284,1,285
2025-08-27T04:26:16Z,pre_sentiment,gpt-4.1-mini,283,1,284
2025-08-27T04:26:20Z,sentiment,gpt-4.1-mini,1299,167,1466
2025-08-27T04:26:20Z,pre_sentiment,gpt-4.1-mini,289,1,290
2025-08-27T04:26:20Z,pre_sentiment,gpt-4.1-mini,278,1,279
2025-08-27T04:26:21Z,pre_sentiment,gpt-4.1-mini,287,1,288
2025-08-27T04:26:24Z,sentiment,gpt-4.1-mini,2502,159,2661
2025-08-27T04:26:25Z,pre_sentiment,gpt-4.1-mini,289,1,290
2025-08-27T04:26:26Z,pre_sentiment,gpt-4.1-mini,280,1,281
2025-08-27T04:26:27Z,pre_sentiment,gpt-4.1-mini,284,1,285
2025-08-27T04:26:27Z,pre_sentiment,gpt-4.1-mini,285,1,286
2025-08-27T04:26:28Z,pre_sentiment,gpt-4.1-mini,290,1,291
2025-08-27T04:26:28Z,pre_sentiment,gpt-4.1-mini,279,1,280
2025-08-27T04:26:28Z,pre_sentiment,gpt-4.1-mini,288,1,289
2025-08-27T04:26:29Z,pre_sentiment,gpt-4.1-mini,279,1,280
2025-08-27T04:26:33Z,pre_sentiment,gpt-4.1-mini,279,1,280
2025-08-27T04:26:36Z,sentiment,gpt-4.1-mini,1344,166,1510
2025-08-27T04:26:36Z,pre_sentiment,gpt-4.1-mini,282,1,283
2025-08-27T04:26:50Z,pre_sentiment,gpt-4.1-mini,284,1,285
2025-08-27T04:26:50Z,pre_sentiment,gpt-4.1-mini,287,1,288
2025-08-27T04:26:53Z,sentiment,gpt-4.1-mini,1511,199,1710
2025-08-27T04:26:54Z,pre_sentiment,gpt-4.1-mini,285,1,286
2025-08-27T04:26:58Z,sentiment,gpt-4.1-mini,1715,190,1905
2025-08-27T04:26:58Z,pre_sentiment,gpt-4.1-mini,280,1,281
2025-08-27T04:27:02Z,sentiment,gpt-4.1-mini,1463,213,1676
2025-08-27T04:27:03Z,pre_sentiment,gpt-4.1-mini,276,1,277
2025-08-27T04:27:07Z,sentiment,gpt-4.1-mini,1954,220,2174
2025-08-27T04:27:08Z,pre_sentiment,gpt-4.1-mini,283,1,284
2025-08-27T04:27:12Z,sentiment,gpt-4.1-mini,1476,242,1718
2025-08-27T04:27:14Z,pre_sentiment,gpt-4.1-mini,282,1,283
2025-08-27T04:27:18Z,sentiment,gpt-4.1-mini,1742,205,1947
2025-08-27T04:27:18Z,pre_sentiment,gpt-4.1-mini,284,1,285
2025-08-27T04:27:23Z,sentiment,gpt-4.1-mini,1903,215,2118
2025-08-27T04:27:23Z,pre_sentiment,gpt-4.1-mini,280,1,281
2025-08-27T04:27:26Z,sentiment,gpt-4.1-mini,1404,221,1625
2025-08-27T04:27:27Z,pre_sentiment,gpt-4.1-mini,287,1,288
2025-08-27T04:27:27Z,pre_sentiment,gpt-4.1-mini,283,1,284
2025-08-27T04:27:30Z,sentiment,gpt-4.1-mini,1881,185,2066
2025-08-27T04:27:31Z,pre_sentiment,gpt-4.1-mini,289,1,290
2025-08-27T04:27:31Z,pre_sentiment,gpt-4.1-mini,287,1,288
2025-08-27T04:27:46Z,pre_sentiment,gpt-4.1-mini,296,1,297
2025-08-27T04:27:47Z,sentiment,gpt-4.1-mini,914,109,1023
2025-08-27T04:27:48Z,pre_sentiment,gpt-4.1-mini,300,1,301
2025-08-27T04:27:50Z,sentiment,gpt-4.1-mini,1027,128,1155
2025-08-27T04:27:50Z,pre_sentiment,gpt-4.1-mini,297,1,298
2025-08-27T04:27:53Z,sentiment,gpt-4.1-mini,1053,186,1239
2025-08-27T04:27:53Z,pre_sentiment,gpt-4.1-mini,301,1,302
2025-08-27T04:27:55Z,sentiment,gpt-4.1-mini,1052,114,1166
2025-08-27T04:27:55Z,pre_sentiment,gpt-4.1-mini,296,1,297
2025-08-27T04:27:57Z,sentiment,gpt-4.1-mini,1006,85,1091
2025-08-27T04:27:57Z,pre_sentiment,gpt-4.1-mini,296,1,297
2025-08-27T04:28:00Z,sentiment,gpt-4.1-mini,1332,191,1523
2025-08-27T04:28:00Z,pre_sentiment,gpt-4.1-mini,302,1,303
2025-08-27T04:28:02Z,sentiment,gpt-4.1-mini,914,86,1000
2025-08-27T04:28:02Z,pre_sentiment,gpt-4.1-mini,298,1,299
2025-08-27T04:28:04Z,sentiment,gpt-4.1-mini,928,118,1046
2025-08-27T04:28:05Z,pre_sentiment,gpt-4.1-mini,291,1,292
2025-08-27T04:28:06Z,sentiment,gpt-4.1-mini,899,88,987
2025-08-27T04:28:06Z,pre_sentiment,gpt-4.1-mini,293,1,294
2025-08-27T04:28:08Z,sentiment,gpt-4.1-mini,901,81,982
2025-08-27T04:28:08Z,pre_sentiment,gpt-4.1-mini,294,1,295
2025-08-27T04:28:09Z,sentiment,gpt-4.1-mini,904,86,990
2025-08-27T04:28:10Z,pre_sentiment,gpt-4.1-mini,298,1,299
2025-08-27T04:28:13Z,sentiment,gpt-4.1-mini,3154,221,3375
2025-08-27T04:28:14Z,pre_sentiment,gpt-4.1-mini,303,1,304
2025-08-27T04:28:17Z,sentiment,gpt-4.1-mini,1817,199,2016
2025-08-27T04:28:17Z,pre_sentiment,gpt-4.1-mini,295,1,296
2025-08-27T04:28:20Z,sentiment,gpt-4.1-mini,2396,177,2573
2025-08-27T04:28:20Z,pre_sentiment,gpt-4.1-mini,299,1,300
2025-08-27T04:28:24Z,sentiment,gpt-4.1-mini,1406,170,1576
2025-08-27T04:28:42Z,pre_sentiment,gpt-4.1-mini,284,1,285
2025-08-27T04:28:45Z,sentiment,gpt-4.1-mini,1788,168,1956
2025-08-27T04:28:46Z,pre_sentiment,gpt-4.1-mini,278,1,279
2025-08-27T04:28:49Z,sentiment,gpt-4.1-mini,1133,144,1277
2025-08-27T04:28:49Z,pre_sentiment,gpt-4.1-mini,289,1,290
2025-08-27T04:28:51Z,sentiment,gpt-4.1-mini,1077,124,1201
2025-08-27T04:28:51Z,pre_sentiment,gpt-4.1-mini,282,1,283
2025-08-27T04:28:54Z,sentiment,gpt-4.1-mini,1935,184,2119
2025-08-27T04:28:55Z,pre_sentiment,gpt-4.1-mini,297,1,298
2025-08-27T04:28:58Z,sentiment,gpt-4.1-mini,1555,142,1697
2025-08-27T04:29:02Z,pre_sentiment,gpt-4.1-mini,286,1,287
2025-08-27T04:29:05Z,sentiment,gpt-4.1-mini,1803,155,1958
2025-08-27T04:29:05Z,pre_sentiment,gpt-4.1-mini,277,1,278
2025-08-27T04:29:09Z,sentiment,gpt-4.1-mini,2244,190,2434
2025-08-27T04:29:28Z,pre_sentiment,gpt-4.1-mini,282,1,283
2025-08-27T04:29:32Z,pre_sentiment,gpt-4.1-mini,274,1,275
2025-08-27T04:29:32Z,pre_sentiment,gpt-4.1-mini,279,1,280
2025-08-27T04:29:40Z,pre_sentiment,gpt-4.1-mini,287,1,288
2025-08-27T04:29:43Z,sentiment,gpt-4.1-mini,1658,170,1828
2025-08-27T04:29:44Z,pre_sentiment,gpt-4.1-mini,288,1,289
2025-08-27T04:29:47Z,sentiment,gpt-4.1-mini,1461,179,1640
2025-08-27T04:29:48Z,pre_sentiment,gpt-4.1-mini,279,1,280
2025-08-27T04:29:51Z,sentiment,gpt-4.1-mini,3962,198,4160
2025-08-27T04:29:51Z,pre_sentiment,gpt-4.1-mini,284,1,285
2025-08-27T04:29:55Z,sentiment,gpt-4.1-mini,1429,179,1608
2025-08-27T04:30:10Z,pre_sentiment,gpt-4.1-mini,287,1,288
2025-08-27T04:30:12Z,sentiment,gpt-4.1-mini,1184,125,1309
2025-08-27T04:30:30Z,pre_sentiment,gpt-4.1-mini,288,1,289
2025-08-27T04:30:33Z,sentiment,gpt-4.1-mini,1149,171,1320
2025-08-27T04:30:37Z,pre_sentiment,gpt-4.1-mini,291,1,292
2025-08-27T04:30:37Z,pre_sentiment,gpt-4.1-mini,286,1,287
2025-08-27T04:30:41Z,sentiment,gpt-4.1-mini,1581,219,1800
2025-08-27T04:30:42Z,pre_sentiment,gpt-4.1-mini,291,1,292
2025-08-27T04:30:45Z,sentiment,gpt-4.1-mini,1767,179,1946
2025-08-27T04:30:46Z,pre_sentiment,gpt-4.1-mini,285,1,286
2025-08-27T04:30:48Z,sentiment,gpt-4.1-mini,1776,169,1945
2025-08-27T04:31:03Z,pre_sentiment,gpt-4.1-mini,291,1,292
2025-08-27T04:31:04Z,pre_sentiment,gpt-4.1-mini,281,1,282
2025-08-27T04:31:04Z,pre_sentiment,gpt-4.1-mini,285,1,286
2025-08-27T04:31:08Z,sentiment,gpt-4.1-mini,1192,197,1389
2025-08-27T04:31:08Z,pre_sentiment,gpt-4.1-mini,285,1,286
2025-08-27T04:31:20Z,pre_sentiment,gpt-4.1-mini,285,1,286
2025-08-27T04:31:24Z,sentiment,gpt-4.1-mini,1885,197,2082
2025-08-27T04:31:24Z,pre_sentiment,gpt-4.1-mini,288,1,289
2025-08-27T04:31:24Z,pre_sentiment,gpt-4.1-mini,278,1,279
2025-08-27T04:31:25Z,pre_sentiment,gpt-4.1-mini,285,1,286
2025-08-27T04:31:37Z,pre_sentiment,gpt-4.1-mini,292,1,293
2025-08-27T04:31:37Z,pre_sentiment,gpt-4.1-mini,286,1,287
2025-08-27T04:31:38Z,pre_sentiment,gpt-4.1-mini,294,1,295
2025-08-27T04:31:39Z,pre_sentiment,gpt-4.1-mini,280,1,281
2025-08-27T04:31:39Z,pre_sentiment,gpt-4.1-mini,283,1,284
2025-08-27T04:31:45Z,sentiment,gpt-4.1-mini,1082,185,1267
2025-08-27T04:31:45Z,pre_sentiment,gpt-4.1-mini,282,1,283
2025-08-27T04:31:45Z,pre_sentiment,gpt-4.1-mini,285,1,286
2025-08-27T04:31:49Z,sentiment,gpt-4.1-mini,1380,226,1606
2025-08-27T04:31:49Z,pre_sentiment,gpt-4.1-mini,287,1,288
2025-08-27T04:31:50Z,pre_sentiment,gpt-4.1-mini,288,1,289
2025-08-27T04:31:52Z,sentiment,gpt-4.1-mini,1235,136,1371
2025-08-27T04:31:52Z,pre_sentiment,gpt-4.1-mini,281,1,282
2025-08-27T04:31:53Z,pre_sentiment,gpt-4.1-mini,292,1,293
2025-08-27T04:31:55Z,sentiment,gpt-4.1-mini,2096,157,2253
2025-08-27T04:31:55Z,pre_sentiment,gpt-4.1-mini,284,1,285
2025-08-27T04:31:59Z,sentiment,gpt-4.1-mini,1329,211,1540
2025-08-27T04:32:07Z,article_selection,gpt-4.1-mini,1535,9,1544
2025-08-27T04:32:08Z,article_selection,gpt-4.1-mini,1133,13,1146
2025-08-27T04:32:08Z,article_selection,gpt-4.1-mini,476,9,485
2025-08-27T04:32:08Z,article_selection,gpt-4.1-mini,872,9,881
2025-08-27T04:32:09Z,article_selection,gpt-4.1-mini,868,9,877
2025-08-27T04:32:28Z,final_summary_en,gpt-4.1-mini,1240,1099,2339
2025-08-27T04:32:49Z,final_summary_en,gpt-4.1-mini,1712,1222,2934
2025-08-27T04:33:06Z,final_summary_en,gpt-4.1-mini,1165,1141,2306
2025-08-27T04:33:20Z,final_summary_en,gpt-4.1-mini,1342,972,2314
2025-08-27T04:33:37Z,final_summary_en,gpt-4.1-mini,1230,972,2202
2025-08-27T04:33:58Z,final_summary_en,gpt-4.1-mini,1201,1092,2293
2025-08-27T04:34:14Z,final_summary_en,gpt-4.1-mini,1138,876,2014
2025-08-27T04:34:31Z,final_summary_en,gpt-4.1-mini,2000,1035,3035
2025-08-27T04:34:47Z,final_summary_en,gpt-4.1-mini,1637,1094,2731
2025-08-27T04:35:02Z,final_summary_en,gpt-4.1-mini,1396,1080,2476
2025-08-27T04:35:18Z,final_summary_en,gpt-4.1-mini,1039,1063,2102
2025-08-27T04:35:34Z,final_summary_en,gpt-4.1-mini,1263,1052,2315
2025-08-27T04:35:49Z,final_summary_en,gpt-4.1-mini,1461,995,2456
2025-08-27T04:36:13Z,final_summary_en,gpt-4.1-mini,1663,1275,2938
2025-08-27T04:36:34Z,final_summary_en,gpt-4.1-mini,2907,1058,3965
2025-08-27T04:36:52Z,final_summary_en,gpt-4.1-mini,944,1049,1993
2025-08-27T04:37:16Z,final_summary_en,gpt-4.1-mini,894,900,1794
2025-08-27T04:37:37Z,final_summary_en,gpt-4.1-mini,1645,1201,2846
2025-08-27T04:38:59Z,category_summary,gpt-4.1-mini,121,43,164
2025-08-27T04:39:01Z,category_summary,gpt-4.1-mini,125,28,153
2025-08-27T04:39:03Z,category_summary,gpt-4.1-mini,101,33,134
2025-08-27T04:39:07Z,category_summary,gpt-4.1-mini,133,49,182
2025-08-27T04:39:08Z,category_summary,gpt-4.1-mini,128,33,161
2025-08-27T04:39:09Z,RUN_TOTAL,,133057,27921,160978
2025-08-28T04:25:49Z,pre_sentiment,gpt-4.1-mini,280,1,281
2025-08-28T04:25:50Z,pre_sentiment,gpt-4.1-mini,281,1,282
2025-08-28T04:25:50Z,pre_sentiment,gpt-4.1-mini,287,1,288
2025-08-28T04:25:51Z,pre_sentiment,gpt-4.1-mini,281,1,282
2025-08-28T04:25:54Z,sentiment,gpt-4.1-mini,2075,177,2252
2025-08-28T04:25:55Z,pre_sentiment,gpt-4.1-mini,286,1,287
2025-08-28T04:25:56Z,pre_sentiment,gpt-4.1-mini,291,1,292
2025-08-28T04:25:56Z,pre_sentiment,gpt-4.1-mini,282,1,283
2025-08-28T04:25:57Z,pre_sentiment,gpt-4.1-mini,292,1,293
2025-08-28T04:26:00Z,sentiment,gpt-4.1-mini,1699,175,1874
2025-08-28T04:26:00Z,pre_sentiment,gpt-4.1-mini,284,1,285
2025-08-28T04:26:01Z,pre_sentiment,gpt-4.1-mini,276,1,277
2025-08-28T04:26:02Z,pre_sentiment,gpt-4.1-mini,276,1,277
2025-08-28T04:26:02Z,pre_sentiment,gpt-4.1-mini,289,1,290
2025-08-28T04:26:02Z,pre_sentiment,gpt-4.1-mini,288,1,289
2025-08-28T04:26:05Z,sentiment,gpt-4.1-mini,1647,183,1830
2025-08-28T04:26:05Z,pre_sentiment,gpt-4.1-mini,284,1,285
2025-08-28T04:26:06Z,pre_sentiment,gpt-4.1-mini,280,1,281
2025-08-28T04:26:13Z,pre_sentiment,gpt-4.1-mini,276,1,277
2025-08-28T04:26:14Z,pre_sentiment,gpt-4.1-mini,273,1,274
2025-08-28T04:26:14Z,pre_sentiment,gpt-4.1-mini,280,1,281
2025-08-28T04:26:17Z,sentiment,gpt-4.1-mini,1258,168,1426
2025-08-28T04:26:18Z,pre_sentiment,gpt-4.1-mini,281,1,282
2025-08-28T04:26:18Z,pre_sentiment,gpt-4.1-mini,282,1,283
2025-08-28T04:26:18Z,pre_sentiment,gpt-4.1-mini,279,1,280
2025-08-28T04:26:19Z,pre_sentiment,gpt-4.1-mini,279,1,280
2025-08-28T04:26:21Z,sentiment,gpt-4.1-mini,1194,135,1329
2025-08-28T04:26:27Z,pre_sentiment,gpt-4.1-mini,284,1,285
2025-08-28T04:26:29Z,sentiment,gpt-4.1-mini,1521,166,1687
2025-08-28T04:26:36Z,pre_sentiment,gpt-4.1-mini,280,1,281
2025-08-28T04:26:39Z,sentiment,gpt-4.1-mini,1833,199,2032
2025-08-28T04:26:40Z,pre_sentiment,gpt-4.1-mini,289,1,290
2025-08-28T04:26:44Z,sentiment,gpt-4.1-mini,1548,175,1723
2025-08-28T04:26:45Z,pre_sentiment,gpt-4.1-mini,291,1,292
2025-08-28T04:26:48Z,sentiment,gpt-4.1-mini,1882,208,2090
2025-08-28T04:26:48Z,pre_sentiment,gpt-4.1-mini,290,1,291
2025-08-28T04:26:51Z,sentiment,gpt-4.1-mini,2144,228,2372
2025-08-28T04:26:51Z,pre_sentiment,gpt-4.1-mini,284,1,285
2025-08-28T04:26:54Z,sentiment,gpt-4.1-mini,1596,179,1775
2025-08-28T04:26:54Z,pre_sentiment,gpt-4.1-mini,283,1,284
2025-08-28T04:26:57Z,sentiment,gpt-4.1-mini,1910,223,2133
2025-08-28T04:26:58Z,pre_sentiment,gpt-4.1-mini,281,1,282
2025-08-28T04:27:01Z,sentiment,gpt-4.1-mini,2264,237,2501
2025-08-28T04:27:01Z,pre_sentiment,gpt-4.1-mini,282,1,283
2025-08-28T04:27:04Z,sentiment,gpt-4.1-mini,1429,191,1620
2025-08-28T04:27:04Z,pre_sentiment,gpt-4.1-mini,284,1,285
2025-08-28T04:27:07Z,sentiment,gpt-4.1-mini,1430,200,1630
2025-08-28T04:27:08Z,pre_sentiment,gpt-4.1-mini,284,1,285
2025-08-28T04:27:11Z,sentiment,gpt-4.1-mini,1677,220,1897
2025-08-28T04:27:12Z,pre_sentiment,gpt-4.1-mini,279,1,280
2025-08-28T04:27:32Z,pre_sentiment,gpt-4.1-mini,307,1,308
2025-08-28T04:27:32Z,pre_sentiment,gpt-4.1-mini,296,1,297
2025-08-28T04:27:35Z,sentiment,gpt-4.1-mini,1255,174,1429
2025-08-28T04:27:35Z,pre_sentiment,gpt-4.1-mini,293,1,294
2025-08-28T04:27:37Z,sentiment,gpt-4.1-mini,1226,121,1347
2025-08-28T04:27:38Z,pre_sentiment,gpt-4.1-mini,297,1,298
2025-08-28T04:27:39Z,sentiment,gpt-4.1-mini,910,92,1002
2025-08-28T04:27:39Z,pre_sentiment,gpt-4.1-mini,296,1,297
2025-08-28T04:27:41Z,sentiment,gpt-4.1-mini,914,97,1011
2025-08-28T04:27:42Z,pre_sentiment,gpt-4.1-mini,295,1,296
2025-08-28T04:27:45Z,sentiment,gpt-4.1-mini,1046,207,1253
2025-08-28T04:27:45Z,pre_sentiment,gpt-4.1-mini,297,1,298
2025-08-28T04:27:48Z,sentiment,gpt-4.1-mini,2592,184,2776
2025-08-28T04:27:49Z,pre_sentiment,gpt-4.1-mini,307,1,308
2025-08-28T04:27:52Z,sentiment,gpt-4.1-mini,4324,244,4568
2025-08-28T04:27:52Z,pre_sentiment,gpt-4.1-mini,297,1,298
2025-08-28T04:27:57Z,sentiment,gpt-4.1-mini,5533,192,5725
2025-08-28T04:27:57Z,pre_sentiment,gpt-4.1-mini,300,1,301
2025-08-28T04:28:00Z,sentiment,gpt-4.1-mini,1610,191,1801
2025-08-28T04:28:00Z,pre_sentiment,gpt-4.1-mini,301,1,302
2025-08-28T04:28:04Z,sentiment,gpt-4.1-mini,1144,203,1347
2025-08-28T04:28:04Z,pre_sentiment,gpt-4.1-mini,297,1,298
2025-08-28T04:28:07Z,sentiment,gpt-4.1-mini,11188,220,11408
2025-08-28T04:28:08Z,pre_sentiment,gpt-4.1-mini,300,1,301
2025-08-28T04:28:12Z,sentiment,gpt-4.1-mini,4220,219,4439
2025-08-28T04:28:13Z,pre_sentiment,gpt-4.1-mini,294,1,295
2025-08-28T04:28:16Z,sentiment,gpt-4.1-mini,10105,193,10298
2025-08-28T04:28:16Z,pre_sentiment,gpt-4.1-mini,296,1,297
2025-08-28T04:28:19Z,sentiment,gpt-4.1-mini,10528,164,10692
2025-08-28T04:28:38Z,pre_sentiment,gpt-4.1-mini,283,1,284
2025-08-28T04:28:42Z,sentiment,gpt-4.1-mini,2388,208,2596
2025-08-28T04:28:46Z,pre_sentiment,gpt-4.1-mini,279,1,280
2025-08-28T04:28:48Z,sentiment,gpt-4.1-mini,1354,147,1501
2025-08-28T04:28:49Z,pre_sentiment,gpt-4.1-mini,290,1,291
2025-08-28T04:28:49Z,pre_sentiment,gpt-4.1-mini,284,1,285
2025-08-28T04:28:51Z,sentiment,gpt-4.1-mini,2151,155,2306
2025-08-28T04:28:51Z,pre_sentiment,gpt-4.1-mini,280,1,281
2025-08-28T04:28:54Z,sentiment,gpt-4.1-mini,1805,171,1976
2025-08-28T04:28:54Z,pre_sentiment,gpt-4.1-mini,280,1,281
2025-08-28T04:28:56Z,sentiment,gpt-4.1-mini,1397,171,1568
2025-08-28T04:28:57Z,pre_sentiment,gpt-4.1-mini,282,1,283
2025-08-28T04:28:59Z,sentiment,gpt-4.1-mini,1045,121,1166
2025-08-28T04:29:05Z,pre_sentiment,gpt-4.1-mini,290,1,291
2025-08-28T04:29:08Z,sentiment,gpt-4.1-mini,2390,185,2575
2025-08-28T04:29:08Z,pre_sentiment,gpt-4.1-mini,289,1,290
2025-08-28T04:29:11Z,sentiment,gpt-4.1-mini,1184,181,1365
2025-08-28T04:29:16Z,pre_sentiment,gpt-4.1-mini,290,1,291
2025-08-28T04:29:16Z,pre_sentiment,gpt-4.1-mini,266,1,267
2025-08-28T04:29:16Z,pre_sentiment,gpt-4.1-mini,286,1,287
2025-08-28T04:29:20Z,pre_sentiment,gpt-4.1-mini,274,1,275
2025-08-28T04:29:21Z,pre_sentiment,gpt-4.1-mini,276,1,277
2025-08-28T04:29:24Z,sentiment,gpt-4.1-mini,1795,200,1995
2025-08-28T04:29:24Z,pre_sentiment,gpt-4.1-mini,274,1,275
2025-08-28T04:29:28Z,sentiment,gpt-4.1-mini,1763,185,1948
2025-08-28T04:29:28Z,pre_sentiment,gpt-4.1-mini,273,1,274
2025-08-28T04:29:29Z,pre_sentiment,gpt-4.1-mini,274,1,275
2025-08-28T04:29:43Z,pre_sentiment,gpt-4.1-mini,285,1,286
2025-08-28T04:29:46Z,sentiment,gpt-4.1-mini,1436,159,1595
2025-08-28T04:29:47Z,pre_sentiment,gpt-4.1-mini,284,1,285
2025-08-28T04:29:49Z,sentiment,gpt-4.1-mini,1424,142,1566
2025-08-28T04:29:49Z,pre_sentiment,gpt-4.1-mini,280,1,281
2025-08-28T04:29:52Z,sentiment,gpt-4.1-mini,1290,176,1466
2025-08-28T04:29:52Z,pre_sentiment,gpt-4.1-mini,281,1,282
2025-08-28T04:29:54Z,sentiment,gpt-4.1-mini,1698,139,1837
2025-08-28T04:29:54Z,pre_sentiment,gpt-4.1-mini,288,1,289
2025-08-28T04:29:56Z,sentiment,gpt-4.1-mini,1460,145,1605
2025-08-28T04:29:57Z,pre_sentiment,gpt-4.1-mini,278,1,279
2025-08-28T04:29:59Z,sentiment,gpt-4.1-mini,1520,199,1719
2025-08-28T04:30:00Z,pre_sentiment,gpt-4.1-mini,284,1,285
2025-08-28T04:30:02Z,sentiment,gpt-4.1-mini,3150,193,3343
2025-08-28T04:30:03Z,pre_sentiment,gpt-4.1-mini,280,1,281
2025-08-28T04:30:06Z,sentiment,gpt-4.1-mini,1437,185,1622
2025-08-28T04:30:06Z,pre_sentiment,gpt-4.1-mini,282,1,283
2025-08-28T04:30:08Z,sentiment,gpt-4.1-mini,1520,179,1699
2025-08-28T04:30:21Z,pre_sentiment,gpt-4.1-mini,285,1,286
2025-08-28T04:30:25Z,sentiment,gpt-4.1-mini,1164,210,1374
2025-08-28T04:30:38Z,pre_sentiment,gpt-4.1-mini,289,1,290
2025-08-28T04:30:40Z,sentiment,gpt-4.1-mini,1186,116,1302
2025-08-28T04:31:04Z,pre_sentiment,gpt-4.1-mini,291,1,292
2025-08-28T04:31:27Z,pre_sentiment,gpt-4.1-mini,288,1,289
2025-08-28T04:31:27Z,pre_sentiment,gpt-4.1-mini,298,1,299
2025-08-28T04:31:28Z,pre_sentiment,gpt-4.1-mini,283,1,284
2025-08-28T04:31:28Z,pre_sentiment,gpt-4.1-mini,285,1,286
2025-08-28T04:31:29Z,pre_sentiment,gpt-4.1-mini,281,1,282
2025-08-28T04:31:32Z,sentiment,gpt-4.1-mini,1259,226,1485
2025-08-28T04:31:32Z,pre_sentiment,gpt-4.1-mini,287,1,288
2025-08-28T04:31:33Z,pre_sentiment,gpt-4.1-mini,280,1,281
2025-08-28T04:31:50Z,pre_sentiment,gpt-4.1-mini,295,1,296
2025-08-28T04:31:53Z,sentiment,gpt-4.1-mini,2931,166,3097
2025-08-28T04:31:53Z,pre_sentiment,gpt-4.1-mini,279,1,280
2025-08-28T04:31:56Z,sentiment,gpt-4.1-mini,2823,165,2988
2025-08-28T04:32:12Z,pre_sentiment,gpt-4.1-mini,293,1,294
2025-08-28T04:32:12Z,pre_sentiment,gpt-4.1-mini,291,1,292
2025-08-28T04:32:16Z,sentiment,gpt-4.1-mini,1207,124,1331
2025-08-28T04:32:16Z,pre_sentiment,gpt-4.1-mini,278,1,279
2025-08-28T04:32:16Z,pre_sentiment,gpt-4.1-mini,289,1,290
2025-08-28T04:32:17Z,pre_sentiment,gpt-4.1-mini,287,1,288
2025-08-28T04:32:20Z,sentiment,gpt-4.1-mini,1336,200,1536
2025-08-28T04:32:20Z,pre_sentiment,gpt-4.1-mini,298,1,299
2025-08-28T04:32:22Z,sentiment,gpt-4.1-mini,1291,147,1438
2025-08-28T04:32:23Z,pre_sentiment,gpt-4.1-mini,282,1,283
2025-08-28T04:32:23Z,pre_sentiment,gpt-4.1-mini,280,1,281
2025-08-28T04:32:33Z,article_selection,gpt-4.1-mini,1230,13,1243
2025-08-28T04:32:34Z,article_selection,gpt-4.1-mini,507,13,520
2025-08-28T04:32:34Z,article_selection,gpt-4.1-mini,1518,9,1527
2025-08-28T04:32:35Z,article_selection,gpt-4.1-mini,1852,9,1861
2025-08-28T04:32:35Z,article_selection,gpt-4.1-mini,1165,12,1177
2025-08-28T04:32:36Z,article_selection,gpt-4.1-mini,385,6,391
2025-08-28T04:32:51Z,final_summary_en,gpt-4.1-mini,1605,1073,2678
2025-08-28T04:33:07Z,final_summary_en,gpt-4.1-mini,1175,1147,2322
2025-08-28T04:33:19Z,final_summary_en,gpt-4.1-mini,1187,1046,2233
2025-08-28T04:33:31Z,final_summary_en,gpt-4.1-mini,1286,1055,2341
2025-08-28T04:33:46Z,final_summary_en,gpt-4.1-mini,1918,1142,3060
2025-08-28T04:34:00Z,final_summary_en,gpt-4.1-mini,1192,1136,2328
2025-08-28T04:34:14Z,final_summary_en,gpt-4.1-mini,2899,1093,3992
2025-08-28T04:34:27Z,final_summary_en,gpt-4.1-mini,1442,1007,2449
2025-08-28T04:34:39Z,final_summary_en,gpt-4.1-mini,1283,1103,2386
2025-08-28T04:34:51Z,final_summary_en,gpt-4.1-mini,1340,1087,2427
2025-08-28T04:35:03Z,final_summary_en,gpt-4.1-mini,920,939,1859
2025-08-28T04:35:16Z,final_summary_en,gpt-4.1-mini,1388,1033,2421
2025-08-28T04:35:31Z,final_summary_en,gpt-4.1-mini,1550,1173,2723
2025-08-28T04:35:47Z,final_summary_en,gpt-4.1-mini,1519,1216,2735
2025-08-28T04:36:01Z,final_summary_en,gpt-4.1-mini,1019,1085,2104
2025-08-28T04:36:17Z,final_summary_en,gpt-4.1-mini,1634,1111,2745
2025-08-28T04:36:32Z,final_summary_en,gpt-4.1-mini,992,1207,2199
2025-08-28T04:36:48Z,final_summary_en,gpt-4.1-mini,10952,1160,12112
2025-08-28T04:37:01Z,final_summary_en,gpt-4.1-mini,1260,983,2243
2025-08-28T04:37:14Z,final_summary_en,gpt-4.1-mini,1028,915,1943
2025-08-28T04:37:31Z,final_summary_en,gpt-4.1-mini,1177,1157,2334
2025-08-28T04:39:19Z,category_summary,gpt-4.1-mini,130,36,166
2025-08-28T04:39:23Z,category_summary,gpt-4.1-mini,137,27,164
2025-08-28T04:39:26Z,category_summary,gpt-4.1-mini,124,35,159
2025-08-28T04:39:29Z,category_summary,gpt-4.1-mini,127,34,161
2025-08-28T04:39:32Z,category_summary,gpt-4.1-mini,113,37,150
2025-08-28T04:39:34Z,RUN_TOTAL,,202302,33354,235656
2025-08-29T04:26:12Z,pre_sentiment,gpt-4.1-mini,281,1,282
2025-08-29T04:26:16Z,sentiment,gpt-4.1-mini,1712,226,1938
2025-08-29T04:26:17Z,pre_sentiment,gpt-4.1-mini,280,1,281
2025-08-29T04:26:17Z,pre_sentiment,gpt-4.1-mini,285,1,286
2025-08-29T04:26:18Z,pre_sentiment,gpt-4.1-mini,285,1,286
2025-08-29T04:26:19Z,pre_sentiment,gpt-4.1-mini,288,1,289
2025-08-29T04:26:21Z,sentiment,gpt-4.1-mini,1931,193,2124
2025-08-29T04:26:22Z,pre_sentiment,gpt-4.1-mini,281,1,282
2025-08-29T04:26:23Z,pre_sentiment,gpt-4.1-mini,282,1,283
2025-08-29T04:26:23Z,pre_sentiment,gpt-4.1-mini,281,1,282
2025-08-29T04:26:23Z,pre_sentiment,gpt-4.1-mini,281,1,282
2025-08-29T04:26:24Z,pre_sentiment,gpt-4.1-mini,287,1,288
2025-08-29T04:26:24Z,pre_sentiment,gpt-4.1-mini,285,1,286
2025-08-29T04:26:24Z,pre_sentiment,gpt-4.1-mini,284,1,285
2025-08-29T04:26:25Z,pre_sentiment,gpt-4.1-mini,291,1,292
2025-08-29T04:26:26Z,pre_sentiment,gpt-4.1-mini,285,1,286
2025-08-29T04:26:28Z,sentiment,gpt-4.1-mini,1524,172,1696
2025-08-29T04:26:29Z,pre_sentiment,gpt-4.1-mini,285,1,286
2025-08-29T04:26:35Z,pre_sentiment,gpt-4.1-mini,286,1,287
2025-08-29T04:26:35Z,pre_sentiment,gpt-4.1-mini,282,1,283
2025-08-29T04:26:36Z,pre_sentiment,gpt-4.1-mini,273,1,274
2025-08-29T04:26:40Z,sentiment,gpt-4.1-mini,1366,154,1520
2025-08-29T04:26:40Z,pre_sentiment,gpt-4.1-mini,280,1,281
2025-08-29T04:26:43Z,sentiment,gpt-4.1-mini,1258,138,1396
2025-08-29T04:26:43Z,pre_sentiment,gpt-4.1-mini,281,1,282
2025-08-29T04:26:49Z,pre_sentiment,gpt-4.1-mini,276,1,277
2025-08-29T04:26:53Z,pre_sentiment,gpt-4.1-mini,286,1,287
2025-08-29T04:26:56Z,sentiment,gpt-4.1-mini,2450,223,2673
2025-08-29T04:26:57Z,pre_sentiment,gpt-4.1-mini,283,1,284
2025-08-29T04:27:00Z,sentiment,gpt-4.1-mini,1847,217,2064
2025-08-29T04:27:01Z,pre_sentiment,gpt-4.1-mini,279,1,280
2025-08-29T04:27:04Z,sentiment,gpt-4.1-mini,1910,241,2151
2025-08-29T04:27:05Z,pre_sentiment,gpt-4.1-mini,279,1,280
2025-08-29T04:27:05Z,pre_sentiment,gpt-4.1-mini,286,1,287
2025-08-29T04:27:09Z,sentiment,gpt-4.1-mini,2261,224,2485
2025-08-29T04:27:09Z,pre_sentiment,gpt-4.1-mini,281,1,282
2025-08-29T04:27:09Z,pre_sentiment,gpt-4.1-mini,280,1,281
2025-08-29T04:27:14Z,sentiment,gpt-4.1-mini,1541,168,1709
2025-08-29T04:27:31Z,pre_sentiment,gpt-4.1-mini,304,1,305
2025-08-29T04:27:33Z,sentiment,gpt-4.1-mini,1972,124,2096
2025-08-29T04:27:33Z,pre_sentiment,gpt-4.1-mini,308,1,309
2025-08-29T04:27:36Z,sentiment,gpt-4.1-mini,1216,172,1388
2025-08-29T04:27:36Z,pre_sentiment,gpt-4.1-mini,296,1,297
2025-08-29T04:27:37Z,sentiment,gpt-4.1-mini,921,94,1015
2025-08-29T04:27:38Z,pre_sentiment,gpt-4.1-mini,298,1,299
2025-08-29T04:27:39Z,sentiment,gpt-4.1-mini,1237,114,1351
2025-08-29T04:27:40Z,pre_sentiment,gpt-4.1-mini,307,1,308
2025-08-29T04:27:40Z,pre_sentiment,gpt-4.1-mini,293,1,294
2025-08-29T04:27:40Z,pre_sentiment,gpt-4.1-mini,297,1,298
2025-08-29T04:27:42Z,sentiment,gpt-4.1-mini,910,92,1002
2025-08-29T04:27:43Z,pre_sentiment,gpt-4.1-mini,296,1,297
2025-08-29T04:27:45Z,sentiment,gpt-4.1-mini,914,131,1045
2025-08-29T04:27:45Z,pre_sentiment,gpt-4.1-mini,295,1,296
2025-08-29T04:27:48Z,sentiment,gpt-4.1-mini,1046,174,1220
2025-08-29T04:27:48Z,pre_sentiment,gpt-4.1-mini,297,1,298
2025-08-29T04:27:52Z,sentiment,gpt-4.1-mini,2592,200,2792
2025-08-29T04:27:53Z,pre_sentiment,gpt-4.1-mini,307,1,308
2025-08-29T04:28:04Z,sentiment,gpt-4.1-mini,4324,226,4550
2025-08-29T04:28:05Z,pre_sentiment,gpt-4.1-mini,297,1,298
2025-08-29T04:28:07Z,sentiment,gpt-4.1-mini,5533,167,5700
2025-08-29T04:28:08Z,pre_sentiment,gpt-4.1-mini,300,1,301
2025-08-29T04:28:10Z,sentiment,gpt-4.1-mini,1610,172,1782
2025-08-29T04:28:11Z,pre_sentiment,gpt-4.1-mini,301,1,302
2025-08-29T04:28:14Z,sentiment,gpt-4.1-mini,1144,199,1343
2025-08-29T04:28:31Z,pre_sentiment,gpt-4.1-mini,282,1,283
2025-08-29T04:28:33Z,sentiment,gpt-4.1-mini,1145,123,1268
2025-08-29T04:28:34Z,pre_sentiment,gpt-4.1-mini,294,1,295
2025-08-29T04:28:36Z,sentiment,gpt-4.1-mini,1775,161,1936
2025-08-29T04:28:37Z,pre_sentiment,gpt-4.1-mini,284,1,285
2025-08-29T04:28:40Z,sentiment,gpt-4.1-mini,2484,222,2706
2025-08-29T04:28:41Z,pre_sentiment,gpt-4.1-mini,287,1,288
2025-08-29T04:28:44Z,sentiment,gpt-4.1-mini,1343,148,1491
2025-08-29T04:28:44Z,pre_sentiment,gpt-4.1-mini,279,1,280
2025-08-29T04:28:47Z,sentiment,gpt-4.1-mini,1792,191,1983
2025-08-29T04:28:47Z,pre_sentiment,gpt-4.1-mini,284,1,285
2025-08-29T04:28:50Z,sentiment,gpt-4.1-mini,2410,198,2608
2025-08-29T04:28:50Z,pre_sentiment,gpt-4.1-mini,280,1,281
2025-08-29T04:28:53Z,sentiment,gpt-4.1-mini,2130,174,2304
2025-08-29T04:28:59Z,pre_sentiment,gpt-4.1-mini,281,1,282
2025-08-29T04:29:01Z,sentiment,gpt-4.1-mini,1921,152,2073
2025-08-29T04:29:01Z,pre_sentiment,gpt-4.1-mini,283,1,284
2025-08-29T04:29:04Z,sentiment,gpt-4.1-mini,2762,132,2894
2025-08-29T04:29:11Z,pre_sentiment,gpt-4.1-mini,264,1,265
2025-08-29T04:29:15Z,sentiment,gpt-4.1-mini,3254,234,3488
2025-08-29T04:29:16Z,pre_sentiment,gpt-4.1-mini,288,1,289
2025-08-29T04:29:16Z,pre_sentiment,gpt-4.1-mini,265,1,266
2025-08-29T04:29:16Z,pre_sentiment,gpt-4.1-mini,265,1,266
2025-08-29T04:29:17Z,pre_sentiment,gpt-4.1-mini,264,1,265
2025-08-29T04:29:21Z,pre_sentiment,gpt-4.1-mini,276,1,277
2025-08-29T04:29:22Z,pre_sentiment,gpt-4.1-mini,274,1,275
2025-08-29T04:29:25Z,sentiment,gpt-4.1-mini,1826,179,2005
2025-08-29T04:29:25Z,pre_sentiment,gpt-4.1-mini,273,1,274
2025-08-29T04:29:26Z,pre_sentiment,gpt-4.1-mini,273,1,274
2025-08-29T04:29:30Z,sentiment,gpt-4.1-mini,1824,149,1973
2025-08-29T04:29:31Z,pre_sentiment,gpt-4.1-mini,274,1,275
2025-08-29T04:29:38Z,pre_sentiment,gpt-4.1-mini,285,1,286
2025-08-29T04:29:40Z,sentiment,gpt-4.1-mini,1473,170,1643
2025-08-29T04:29:41Z,pre_sentiment,gpt-4.1-mini,281,1,282
2025-08-29T04:29:41Z,pre_sentiment,gpt-4.1-mini,285,1,286
2025-08-29T04:29:45Z,sentiment,gpt-4.1-mini,1485,219,1704
2025-08-29T04:29:45Z,pre_sentiment,gpt-4.1-mini,287,1,288
2025-08-29T04:29:48Z,sentiment,gpt-4.1-mini,1680,194,1874
2025-08-29T04:29:55Z,pre_sentiment,gpt-4.1-mini,284,1,285
2025-08-29T04:29:57Z,sentiment,gpt-4.1-mini,2134,187,2321
2025-08-29T04:29:58Z,pre_sentiment,gpt-4.1-mini,286,1,287
2025-08-29T04:30:00Z,sentiment,gpt-4.1-mini,1013,160,1173
2025-08-29T04:30:07Z,pre_sentiment,gpt-4.1-mini,290,1,291
2025-08-29T04:30:21Z,pre_sentiment,gpt-4.1-mini,292,1,293
2025-08-29T04:30:35Z,pre_sentiment,gpt-4.1-mini,287,1,288
2025-08-29T04:30:38Z,sentiment,gpt-4.1-mini,1306,189,1495
2025-08-29T04:30:38Z,pre_sentiment,gpt-4.1-mini,290,1,291
2025-08-29T04:30:41Z,sentiment,gpt-4.1-mini,1701,196,1897
2025-08-29T04:30:47Z,pre_sentiment,gpt-4.1-mini,290,1,291
2025-08-29T04:30:50Z,sentiment,gpt-4.1-mini,1100,109,1209
2025-08-29T04:30:57Z,pre_sentiment,gpt-4.1-mini,288,1,289
2025-08-29T04:30:57Z,pre_sentiment,gpt-4.1-mini,286,1,287
2025-08-29T04:30:58Z,pre_sentiment,gpt-4.1-mini,293,1,294
2025-08-29T04:30:58Z,pre_sentiment,gpt-4.1-mini,286,1,287
2025-08-29T04:30:59Z,pre_sentiment,gpt-4.1-mini,283,1,284
2025-08-29T04:31:13Z,pre_sentiment,gpt-4.1-mini,288,1,289
2025-08-29T04:31:17Z,sentiment,gpt-4.1-mini,2661,251,2912
2025-08-29T04:31:17Z,pre_sentiment,gpt-4.1-mini,291,1,292
2025-08-29T04:31:17Z,pre_sentiment,gpt-4.1-mini,289,1,290
2025-08-29T04:31:20Z,sentiment,gpt-4.1-mini,2522,212,2734
2025-08-29T04:31:21Z,pre_sentiment,gpt-4.1-mini,283,1,284
2025-08-29T04:31:35Z,pre_sentiment,gpt-4.1-mini,284,1,285
2025-08-29T04:31:36Z,pre_sentiment,gpt-4.1-mini,288,1,289
2025-08-29T04:31:36Z,pre_sentiment,gpt-4.1-mini,285,1,286
2025-08-29T04:31:37Z,pre_sentiment,gpt-4.1-mini,278,1,279
2025-08-29T04:31:37Z,pre_sentiment,gpt-4.1-mini,291,1,292
2025-08-29T04:31:37Z,pre_sentiment,gpt-4.1-mini,277,1,278
2025-08-29T04:31:38Z,pre_sentiment,gpt-4.1-mini,291,1,292
2025-08-29T04:31:38Z,pre_sentiment,gpt-4.1-mini,286,1,287
2025-08-29T04:31:40Z,sentiment,gpt-4.1-mini,1113,146,1259
2025-08-29T04:31:40Z,pre_sentiment,gpt-4.1-mini,284,1,285
2025-08-29T04:31:42Z,sentiment,gpt-4.1-mini,1323,179,1502
2025-08-29T04:31:43Z,pre_sentiment,gpt-4.1-mini,282,1,283
2025-08-29T04:31:43Z,pre_sentiment,gpt-4.1-mini,283,1,284
2025-08-29T04:31:46Z,sentiment,gpt-4.1-mini,1226,189,1415
2025-08-29T04:31:46Z,pre_sentiment,gpt-4.1-mini,284,1,285
2025-08-29T04:31:49Z,sentiment,gpt-4.1-mini,1245,241,1486
2025-08-29T04:31:50Z,pre_sentiment,gpt-4.1-mini,286,1,287
2025-08-29T04:32:03Z,pre_sentiment,gpt-4.1-mini,292,1,293
2025-08-29T04:32:06Z,sentiment,gpt-4.1-mini,5112,256,5368
2025-08-29T04:32:08Z,article_selection,gpt-4.1-mini,1357,9,1366
2025-08-29T04:32:08Z,article_selection,gpt-4.1-mini,1475,16,1491
2025-08-29T04:32:08Z,article_selection,gpt-4.1-mini,1159,7,1166
2025-08-29T04:32:09Z,article_selection,gpt-4.1-mini,3229,9,3238
2025-08-29T04:32:10Z,article_selection,gpt-4.1-mini,622,13,635
2025-08-29T04:32:23Z,final_summary_en,gpt-4.1-mini,2208,956,3164
2025-08-29T04:32:49Z,final_summary_en,gpt-4.1-mini,1674,1041,2715
2025-08-29T04:33:04Z,final_summary_en,gpt-4.1-mini,1534,1216,2750
2025-08-29T04:33:14Z,final_summary_en,gpt-4.1-mini,1439,1038,2477
2025-08-29T04:33:26Z,final_summary_en,gpt-4.1-mini,1485,1167,2652
2025-08-29T04:33:39Z,final_summary_en,gpt-4.1-mini,1613,1159,2772
2025-08-29T04:33:55Z,final_summary_en,gpt-4.1-mini,1678,1320,2998
2025-08-29T04:34:10Z,final_summary_en,gpt-4.1-mini,790,1148,1938
2025-08-29T04:34:24Z,final_summary_en,gpt-4.1-mini,1561,1104,2665
2025-08-29T04:34:38Z,final_summary_en,gpt-4.1-mini,2437,1184,3621
2025-08-29T04:34:54Z,final_summary_en,gpt-4.1-mini,2289,1198,3487
2025-08-29T04:35:14Z,final_summary_en,gpt-4.1-mini,4889,1518,6407
2025-08-29T04:35:30Z,final_summary_en,gpt-4.1-mini,2025,1287,3312
2025-08-29T04:35:47Z,final_summary_en,gpt-4.1-mini,2244,1335,3579
2025-08-29T04:36:07Z,final_summary_en,gpt-4.1-mini,2170,1168,3338
2025-08-29T04:36:21Z,final_summary_en,gpt-4.1-mini,4091,1294,5385
2025-08-29T04:36:34Z,final_summary_en,gpt-4.1-mini,2342,1197,3539
2025-08-29T04:36:50Z,final_summary_en,gpt-4.1-mini,958,1035,1993
2025-08-29T04:37:06Z,final_summary_en,gpt-4.1-mini,1059,1329,2388
2025-08-29T04:38:15Z,category_summary,gpt-4.1-mini,125,36,161
2025-08-29T04:38:18Z,category_summary,gpt-4.1-mini,135,32,167
2025-08-29T04:38:20Z,category_summary,gpt-4.1-mini,129,35,164
2025-08-29T04:38:22Z,category_summary,gpt-4.1-mini,120,29,149
2025-08-29T04:38:24Z,category_summary,gpt-4.1-mini,129,48,177
2025-08-29T04:38:26Z,category_summary,gpt-4.1-mini,82,18,100
2025-08-29T04:38:27Z,RUN_TOTAL,,167141,31823,198964
2025-08-30T04:24:10Z,pre_sentiment,gpt-4.1-mini,279,1,280
2025-08-30T04:24:11Z,pre_sentiment,gpt-4.1-mini,280,1,281
2025-08-30T04:24:11Z,pre_sentiment,gpt-4.1-mini,283,1,284
2025-08-30T04:24:15Z,sentiment,gpt-4.1-mini,2012,200,2212
2025-08-30T04:24:16Z,pre_sentiment,gpt-4.1-mini,285,1,286
2025-08-30T04:24:16Z,pre_sentiment,gpt-4.1-mini,279,1,280
2025-08-30T04:24:17Z,pre_sentiment,gpt-4.1-mini,290,1,291
2025-08-30T04:24:18Z,pre_sentiment,gpt-4.1-mini,286,1,287
2025-08-30T04:24:19Z,pre_sentiment,gpt-4.1-mini,279,1,280
2025-08-30T04:24:19Z,pre_sentiment,gpt-4.1-mini,277,1,278
2025-08-30T04:24:19Z,pre_sentiment,gpt-4.1-mini,283,1,284
2025-08-30T04:24:20Z,pre_sentiment,gpt-4.1-mini,281,1,282
2025-08-30T04:24:20Z,pre_sentiment,gpt-4.1-mini,281,1,282
2025-08-30T04:24:20Z,pre_sentiment,gpt-4.1-mini,284,1,285
2025-08-30T04:24:21Z,pre_sentiment,gpt-4.1-mini,294,1,295
2025-08-30T04:24:21Z,pre_sentiment,gpt-4.1-mini,293,1,294
2025-08-30T04:24:24Z,pre_sentiment,gpt-4.1-mini,282,1,283
2025-08-30T04:24:25Z,pre_sentiment,gpt-4.1-mini,289,1,290
2025-08-30T04:24:25Z,pre_sentiment,gpt-4.1-mini,282,1,283
2025-08-30T04:24:36Z,pre_sentiment,gpt-4.1-mini,278,1,279
2025-08-30T04:24:42Z,pre_sentiment,gpt-4.1-mini,293,1,294
2025-08-30T04:24:45Z,sentiment,gpt-4.1-mini,2487,198,2685
2025-08-30T04:24:46Z,pre_sentiment,gpt-4.1-mini,279,1,280
2025-08-30T04:24:49Z,sentiment,gpt-4.1-mini,1372,194,1566
2025-08-30T04:24:49Z,pre_sentiment,gpt-4.1-mini,277,1,278
2025-08-30T04:24:52Z,sentiment,gpt-4.1-mini,1751,188,1939
2025-08-30T04:24:52Z,pre_sentiment,gpt-4.1-mini,282,1,283
2025-08-30T04:24:55Z,sentiment,gpt-4.1-mini,1813,182,1995
2025-08-30T04:24:55Z,pre_sentiment,gpt-4.1-mini,290,1,291
2025-08-30T04:24:58Z,sentiment,gpt-4.1-mini,2218,204,2422
2025-08-30T04:24:59Z,pre_sentiment,gpt-4.1-mini,281,1,282
2025-08-30T04:24:59Z,pre_sentiment,gpt-4.1-mini,283,1,284
2025-08-30T04:25:03Z,sentiment,gpt-4.1-mini,1543,221,1764
2025-08-30T04:25:04Z,pre_sentiment,gpt-4.1-mini,287,1,288
2025-08-30T04:25:07Z,sentiment,gpt-4.1-mini,2105,232,2337
2025-08-30T04:25:07Z,pre_sentiment,gpt-4.1-mini,280,1,281
2025-08-30T04:25:12Z,sentiment,gpt-4.1-mini,3059,241,3300
2025-08-30T04:25:12Z,pre_sentiment,gpt-4.1-mini,282,1,283
2025-08-30T04:25:15Z,sentiment,gpt-4.1-mini,1879,201,2080
2025-08-30T04:25:15Z,pre_sentiment,gpt-4.1-mini,288,1,289
2025-08-30T04:25:18Z,sentiment,gpt-4.1-mini,1463,153,1616
2025-08-30T04:25:18Z,pre_sentiment,gpt-4.1-mini,285,1,286
2025-08-30T04:25:21Z,sentiment,gpt-4.1-mini,1566,225,1791
2025-08-30T04:25:36Z,pre_sentiment,gpt-4.1-mini,299,1,300
2025-08-30T04:25:38Z,sentiment,gpt-4.1-mini,913,77,990
2025-08-30T04:25:38Z,pre_sentiment,gpt-4.1-mini,295,1,296
2025-08-30T04:25:39Z,pre_sentiment,gpt-4.1-mini,300,1,301
2025-08-30T04:25:42Z,sentiment,gpt-4.1-mini,1004,179,1183
2025-08-30T04:25:42Z,pre_sentiment,gpt-4.1-mini,300,1,301
2025-08-30T04:25:45Z,sentiment,gpt-4.1-mini,1005,138,1143
2025-08-30T04:25:45Z,pre_sentiment,gpt-4.1-mini,299,1,300
2025-08-30T04:25:49Z,sentiment,gpt-4.1-mini,1345,178,1523
2025-08-30T04:25:49Z,pre_sentiment,gpt-4.1-mini,299,1,300
2025-08-30T04:25:53Z,sentiment,gpt-4.1-mini,1747,206,1953
2025-08-30T04:25:53Z,pre_sentiment,gpt-4.1-mini,298,1,299
2025-08-30T04:25:53Z,pre_sentiment,gpt-4.1-mini,301,1,302
2025-08-30T04:25:54Z,pre_sentiment,gpt-4.1-mini,293,1,294
2025-08-30T04:25:58Z,sentiment,gpt-4.1-mini,2592,210,2802
2025-08-30T04:25:58Z,pre_sentiment,gpt-4.1-mini,294,1,295
2025-08-30T04:25:59Z,pre_sentiment,gpt-4.1-mini,304,1,305
2025-08-30T04:26:01Z,sentiment,gpt-4.1-mini,1972,141,2113
2025-08-30T04:26:01Z,pre_sentiment,gpt-4.1-mini,296,1,297
2025-08-30T04:26:03Z,sentiment,gpt-4.1-mini,921,91,1012
2025-08-30T04:26:03Z,pre_sentiment,gpt-4.1-mini,298,1,299
2025-08-30T04:26:05Z,sentiment,gpt-4.1-mini,1239,120,1359
2025-08-30T04:26:06Z,pre_sentiment,gpt-4.1-mini,303,1,304
2025-08-30T04:26:20Z,pre_sentiment,gpt-4.1-mini,279,1,280
2025-08-30T04:26:23Z,sentiment,gpt-4.1-mini,1789,221,2010
2025-08-30T04:26:24Z,pre_sentiment,gpt-4.1-mini,293,1,294
2025-08-30T04:26:26Z,sentiment,gpt-4.1-mini,1123,135,1258
2025-08-30T04:26:26Z,pre_sentiment,gpt-4.1-mini,279,1,280
2025-08-30T04:26:29Z,sentiment,gpt-4.1-mini,1409,156,1565
2025-08-30T04:26:34Z,pre_sentiment,gpt-4.1-mini,283,1,284
2025-08-30T04:26:38Z,sentiment,gpt-4.1-mini,947,168,1115
2025-08-30T04:26:43Z,pre_sentiment,gpt-4.1-mini,296,1,297
2025-08-30T04:26:43Z,pre_sentiment,gpt-4.1-mini,288,1,289
2025-08-30T04:26:47Z,pre_sentiment,gpt-4.1-mini,274,1,275
2025-08-30T04:26:48Z,pre_sentiment,gpt-4.1-mini,275,1,276
2025-08-30T04:26:48Z,pre_sentiment,gpt-4.1-mini,276,1,277
2025-08-30T04:26:48Z,pre_sentiment,gpt-4.1-mini,275,1,276
2025-08-30T04:26:49Z,pre_sentiment,gpt-4.1-mini,276,1,277
2025-08-30T04:26:49Z,pre_sentiment,gpt-4.1-mini,275,1,276
2025-08-30T04:26:50Z,pre_sentiment,gpt-4.1-mini,276,1,277
2025-08-30T04:26:59Z,pre_sentiment,gpt-4.1-mini,277,1,278
2025-08-30T04:27:03Z,sentiment,gpt-4.1-mini,1554,222,1776
2025-08-30T04:27:03Z,pre_sentiment,gpt-4.1-mini,286,1,287
2025-08-30T04:27:07Z,sentiment,gpt-4.1-mini,1810,156,1966
2025-08-30T04:27:07Z,pre_sentiment,gpt-4.1-mini,287,1,288
2025-08-30T04:27:10Z,sentiment,gpt-4.1-mini,1632,185,1817
2025-08-30T04:27:10Z,pre_sentiment,gpt-4.1-mini,285,1,286
2025-08-30T04:27:13Z,sentiment,gpt-4.1-mini,1549,167,1716
2025-08-30T04:27:13Z,pre_sentiment,gpt-4.1-mini,278,1,279
2025-08-30T04:27:13Z,pre_sentiment,gpt-4.1-mini,286,1,287
2025-08-30T04:27:14Z,pre_sentiment,gpt-4.1-mini,287,1,288
2025-08-30T04:27:16Z,sentiment,gpt-4.1-mini,1991,171,2162
2025-08-30T04:27:17Z,pre_sentiment,gpt-4.1-mini,286,1,287
2025-08-30T04:27:20Z,sentiment,gpt-4.1-mini,2592,134,2726
2025-08-30T04:27:25Z,pre_sentiment,gpt-4.1-mini,287,1,288
2025-08-30T04:27:27Z,sentiment,gpt-4.1-mini,1111,135,1246
2025-08-30T04:27:28Z,pre_sentiment,gpt-4.1-mini,289,1,290
2025-08-30T04:27:30Z,sentiment,gpt-4.1-mini,1034,143,1177
2025-08-30T04:27:36Z,pre_sentiment,gpt-4.1-mini,295,1,296
2025-08-30T04:27:38Z,sentiment,gpt-4.1-mini,1120,127,1247
2025-08-30T04:27:38Z,pre_sentiment,gpt-4.1-mini,287,1,288
2025-08-30T04:27:41Z,sentiment,gpt-4.1-mini,1111,143,1254
2025-08-30T04:27:44Z,pre_sentiment,gpt-4.1-mini,287,1,288
2025-08-30T04:27:46Z,sentiment,gpt-4.1-mini,1111,119,1230
2025-08-30T04:28:02Z,pre_sentiment,gpt-4.1-mini,299,1,300
2025-08-30T04:28:06Z,sentiment,gpt-4.1-mini,6484,212,6696
2025-08-30T04:28:07Z,pre_sentiment,gpt-4.1-mini,286,1,287
2025-08-30T04:28:11Z,sentiment,gpt-4.1-mini,1754,211,1965
2025-08-30T04:28:11Z,pre_sentiment,gpt-4.1-mini,291,1,292
2025-08-30T04:28:14Z,sentiment,gpt-4.1-mini,1572,155,1727
2025-08-30T04:28:33Z,pre_sentiment,gpt-4.1-mini,284,1,285
2025-08-30T04:28:33Z,pre_sentiment,gpt-4.1-mini,292,1,293
2025-08-30T04:28:34Z,pre_sentiment,gpt-4.1-mini,285,1,286
2025-08-30T04:28:36Z,sentiment,gpt-4.1-mini,1677,186,1863
2025-08-30T04:28:37Z,pre_sentiment,gpt-4.1-mini,288,1,289
2025-08-30T04:28:37Z,pre_sentiment,gpt-4.1-mini,292,1,293
2025-08-30T04:28:41Z,sentiment,gpt-4.1-mini,1236,205,1441
2025-08-30T04:28:41Z,pre_sentiment,gpt-4.1-mini,295,1,296
2025-08-30T04:28:41Z,pre_sentiment,gpt-4.1-mini,285,1,286
2025-08-30T04:28:55Z,pre_sentiment,gpt-4.1-mini,284,1,285
2025-08-30T04:28:58Z,sentiment,gpt-4.1-mini,2572,240,2812
2025-08-30T04:29:11Z,pre_sentiment,gpt-4.1-mini,285,1,286
2025-08-30T04:29:14Z,sentiment,gpt-4.1-mini,1068,159,1227
2025-08-30T04:29:14Z,pre_sentiment,gpt-4.1-mini,285,1,286
2025-08-30T04:29:14Z,pre_sentiment,gpt-4.1-mini,281,1,282
2025-08-30T04:29:18Z,sentiment,gpt-4.1-mini,1187,172,1359
2025-08-30T04:29:18Z,pre_sentiment,gpt-4.1-mini,288,1,289
2025-08-30T04:29:20Z,sentiment,gpt-4.1-mini,1213,176,1389
2025-08-30T04:29:21Z,pre_sentiment,gpt-4.1-mini,289,1,290
2025-08-30T04:29:24Z,sentiment,gpt-4.1-mini,1205,183,1388
2025-08-30T04:29:24Z,pre_sentiment,gpt-4.1-mini,297,1,298
2025-08-30T04:29:27Z,sentiment,gpt-4.1-mini,1409,160,1569
2025-08-30T04:29:27Z,pre_sentiment,gpt-4.1-mini,282,1,283
2025-08-30T04:29:27Z,pre_sentiment,gpt-4.1-mini,287,1,288
2025-08-30T04:29:28Z,pre_sentiment,gpt-4.1-mini,283,1,284
2025-08-30T04:29:28Z,pre_sentiment,gpt-4.1-mini,280,1,281
2025-08-30T04:29:28Z,pre_sentiment,gpt-4.1-mini,285,1,286
2025-08-30T04:29:31Z,sentiment,gpt-4.1-mini,1284,201,1485
2025-08-30T04:29:32Z,pre_sentiment,gpt-4.1-mini,283,1,284
2025-08-30T04:29:40Z,article_selection,gpt-4.1-mini,1084,9,1093
2025-08-30T04:29:40Z,article_selection,gpt-4.1-mini,962,9,971
2025-08-30T04:29:41Z,article_selection,gpt-4.1-mini,674,9,683
2025-08-30T04:29:41Z,article_selection,gpt-4.1-mini,479,6,485
2025-08-30T04:29:42Z,article_selection,gpt-4.1-mini,891,12,903
2025-08-30T04:29:42Z,article_selection,gpt-4.1-mini,780,12,792
2025-08-30T04:30:05Z,final_summary_en,gpt-4.1-mini,2818,1421,4239
2025-08-30T04:30:20Z,final_summary_en,gpt-4.1-mini,1311,1084,2395
2025-08-30T04:30:40Z,final_summary_en,gpt-4.1-mini,1876,1296,3172
2025-08-30T04:30:54Z,final_summary_en,gpt-4.1-mini,1315,979,2294
2025-08-30T04:31:14Z,final_summary_en,gpt-4.1-mini,1113,1314,2427
2025-08-30T04:31:30Z,final_summary_en,gpt-4.1-mini,1496,973,2469
2025-08-30T04:31:51Z,final_summary_en,gpt-4.1-mini,1547,1337,2884
2025-08-30T04:32:07Z,final_summary_en,gpt-4.1-mini,1080,907,1987
2025-08-30T04:32:14Z,final_summary_en,gpt-4.1-mini,1504,1119,2623
2025-08-30T04:32:28Z,final_summary_en,gpt-4.1-mini,1765,1092,2857
2025-08-30T04:32:47Z,final_summary_en,gpt-4.1-mini,1513,1119,2632
2025-08-30T04:33:07Z,final_summary_en,gpt-4.1-mini,2349,1196,3545
2025-08-30T04:33:25Z,final_summary_en,gpt-4.1-mini,2243,1328,3571
2025-08-30T04:33:40Z,final_summary_en,gpt-4.1-mini,1551,1038,2589
2025-08-30T04:33:55Z,final_summary_en,gpt-4.1-mini,1328,1074,2402
2025-08-30T04:34:02Z,final_summary_en,gpt-4.1-mini,756,830,1586
2025-08-30T04:34:12Z,final_summary_en,gpt-4.1-mini,6250,1185,7435
2025-08-30T04:34:26Z,final_summary_en,gpt-4.1-mini,685,1098,1783
2025-08-30T04:34:35Z,final_summary_en,gpt-4.1-mini,1428,1145,2573
2025-08-30T04:34:46Z,final_summary_en,gpt-4.1-mini,2340,1252,3592
2025-08-30T04:34:55Z,final_summary_en,gpt-4.1-mini,990,1055,2045
2025-08-30T04:35:07Z,final_summary_en,gpt-4.1-mini,1037,1179,2216
2025-08-30T04:35:19Z,final_summary_en,gpt-4.1-mini,1980,1219,3199
2025-08-30T04:36:24Z,category_summary,gpt-4.1-mini,126,29,155
2025-08-30T04:36:26Z,category_summary,gpt-4.1-mini,148,26,174
2025-08-30T04:36:27Z,category_summary,gpt-4.1-mini,118,23,141
2025-08-30T04:36:29Z,category_summary,gpt-4.1-mini,142,47,189
2025-08-30T04:36:31Z,category_summary,gpt-4.1-mini,101,34,135
2025-08-30T04:36:33Z,category_summary,gpt-4.1-mini,128,26,154
2025-08-30T04:36:34Z,RUN_TOTAL,,153397,34997,188394
2025-08-31T04:24:32Z,pre_sentiment,gpt-4.1-mini,286,1,287
2025-08-31T04:24:35Z,sentiment,gpt-4.1-mini,1779,172,1951
2025-08-31T04:24:36Z,pre_sentiment,gpt-4.1-mini,284,1,285
2025-08-31T04:24:37Z,pre_sentiment,gpt-4.1-mini,282,1,283
2025-08-31T04:24:39Z,sentiment,gpt-4.1-mini,1333,134,1467
2025-08-31T04:24:40Z,pre_sentiment,gpt-4.1-mini,276,1,277
2025-08-31T04:24:41Z,pre_sentiment,gpt-4.1-mini,291,1,292
2025-08-31T04:24:41Z,pre_sentiment,gpt-4.1-mini,289,1,290
2025-08-31T04:24:47Z,sentiment,gpt-4.1-mini,2491,195,2686
2025-08-31T04:24:47Z,pre_sentiment,gpt-4.1-mini,284,1,285
2025-08-31T04:24:48Z,pre_sentiment,gpt-4.1-mini,292,1,293
2025-08-31T04:24:48Z,pre_sentiment,gpt-4.1-mini,280,1,281
2025-08-31T04:24:48Z,pre_sentiment,gpt-4.1-mini,281,1,282
2025-08-31T04:24:53Z,sentiment,gpt-4.1-mini,1730,201,1931
2025-08-31T04:24:53Z,pre_sentiment,gpt-4.1-mini,288,1,289
2025-08-31T04:24:56Z,sentiment,gpt-4.1-mini,2160,165,2325
2025-08-31T04:24:56Z,pre_sentiment,gpt-4.1-mini,283,1,284
2025-08-31T04:24:57Z,pre_sentiment,gpt-4.1-mini,285,1,286
2025-08-31T04:25:00Z,sentiment,gpt-4.1-mini,1281,172,1453
2025-08-31T04:25:00Z,pre_sentiment,gpt-4.1-mini,283,1,284
2025-08-31T04:25:16Z,pre_sentiment,gpt-4.1-mini,288,1,289
2025-08-31T04:25:18Z,sentiment,gpt-4.1-mini,2160,165,2325
2025-08-31T04:25:22Z,pre_sentiment,gpt-4.1-mini,282,1,283
2025-08-31T04:25:24Z,sentiment,gpt-4.1-mini,1333,144,1477
2025-08-31T04:25:25Z,pre_sentiment,gpt-4.1-mini,278,1,279
2025-08-31T04:25:30Z,pre_sentiment,gpt-4.1-mini,277,1,278
2025-08-31T04:25:33Z,sentiment,gpt-4.1-mini,1900,214,2114
2025-08-31T04:25:33Z,pre_sentiment,gpt-4.1-mini,284,1,285
2025-08-31T04:25:37Z,sentiment,gpt-4.1-mini,2229,223,2452
2025-08-31T04:25:38Z,pre_sentiment,gpt-4.1-mini,285,1,286
2025-08-31T04:25:41Z,sentiment,gpt-4.1-mini,1442,162,1604
2025-08-31T04:25:41Z,pre_sentiment,gpt-4.1-mini,278,1,279
2025-08-31T04:25:44Z,sentiment,gpt-4.1-mini,1914,196,2110
2025-08-31T04:25:58Z,pre_sentiment,gpt-4.1-mini,299,1,300
2025-08-31T04:25:59Z,sentiment,gpt-4.1-mini,913,95,1008
2025-08-31T04:26:00Z,pre_sentiment,gpt-4.1-mini,295,1,296
2025-08-31T04:26:00Z,pre_sentiment,gpt-4.1-mini,300,1,301
2025-08-31T04:26:04Z,sentiment,gpt-4.1-mini,1004,162,1166
2025-08-31T04:26:04Z,pre_sentiment,gpt-4.1-mini,300,1,301
2025-08-31T04:26:06Z,sentiment,gpt-4.1-mini,1005,123,1128
2025-08-31T04:26:06Z,pre_sentiment,gpt-4.1-mini,298,1,299
2025-08-31T04:26:07Z,pre_sentiment,gpt-4.1-mini,301,1,302
2025-08-31T04:26:07Z,pre_sentiment,gpt-4.1-mini,294,1,295
2025-08-31T04:26:07Z,pre_sentiment,gpt-4.1-mini,304,1,305
2025-08-31T04:26:09Z,sentiment,gpt-4.1-mini,1972,150,2122
2025-08-31T04:26:09Z,pre_sentiment,gpt-4.1-mini,296,1,297
2025-08-31T04:26:11Z,sentiment,gpt-4.1-mini,921,90,1011
2025-08-31T04:26:11Z,pre_sentiment,gpt-4.1-mini,298,1,299
2025-08-31T04:26:13Z,sentiment,gpt-4.1-mini,1239,107,1346
2025-08-31T04:26:13Z,pre_sentiment,gpt-4.1-mini,303,1,304
2025-08-31T04:26:50Z,pre_sentiment,gpt-4.1-mini,260,1,261
2025-08-31T04:26:52Z,sentiment,gpt-4.1-mini,1649,201,1850
2025-08-31T04:27:10Z,pre_sentiment,gpt-4.1-mini,286,1,287
2025-08-31T04:27:19Z,pre_sentiment,gpt-4.1-mini,286,1,287
2025-08-31T04:28:05Z,pre_sentiment,gpt-4.1-mini,288,1,289
2025-08-31T04:28:08Z,sentiment,gpt-4.1-mini,2423,197,2620
2025-08-31T04:28:08Z,pre_sentiment,gpt-4.1-mini,286,1,287
2025-08-31T04:28:11Z,sentiment,gpt-4.1-mini,2376,173,2549
2025-08-31T04:28:22Z,pre_sentiment,gpt-4.1-mini,291,1,292
2025-08-31T04:28:26Z,sentiment,gpt-4.1-mini,1395,245,1640
2025-08-31T04:28:27Z,pre_sentiment,gpt-4.1-mini,289,1,290
2025-08-31T04:28:34Z,article_selection,gpt-4.1-mini,798,12,810
2025-08-31T04:28:34Z,article_selection,gpt-4.1-mini,357,6,363
2025-08-31T04:28:35Z,article_selection,gpt-4.1-mini,383,5,388
2025-08-31T04:28:35Z,article_selection,gpt-4.1-mini,402,5,407
2025-08-31T04:28:49Z,final_summary_en,gpt-4.1-mini,1651,1032,2683
2025-08-31T04:29:02Z,final_summary_en,gpt-4.1-mini,2013,1088,3101
2025-08-31T04:29:23Z,final_summary_en,gpt-4.1-mini,1167,1337,2504
2025-08-31T04:29:36Z,final_summary_en,gpt-4.1-mini,1018,933,1951
2025-08-31T04:29:51Z,final_summary_en,gpt-4.1-mini,2227,1085,3312
2025-08-31T04:30:10Z,final_summary_en,gpt-4.1-mini,1404,1363,2767
2025-08-31T04:30:38Z,final_summary_en,gpt-4.1-mini,1664,1196,2860
2025-08-31T04:30:52Z,final_summary_en,gpt-4.1-mini,2178,1165,3343
2025-08-31T04:31:09Z,final_summary_en,gpt-4.1-mini,1484,1309,2793
2025-08-31T04:31:24Z,final_summary_en,gpt-4.1-mini,1183,1117,2300
2025-08-31T04:31:40Z,final_summary_en,gpt-4.1-mini,1529,1209,2738
2025-08-31T04:32:12Z,category_summary,gpt-4.1-mini,132,29,161
2025-08-31T04:32:13Z,category_summary,gpt-4.1-mini,103,31,134
2025-08-31T04:32:15Z,category_summary,gpt-4.1-mini,84,21,105
2025-08-31T04:32:16Z,category_summary,gpt-4.1-mini,105,29,134
2025-08-31T04:32:18Z,category_summary,gpt-4.1-mini,113,20,133
2025-08-31T04:32:19Z,RUN_TOTAL,,67874,16717,84591
2025-09-01T04:31:04Z,pre_sentiment,gpt-4.1-mini,277,1,278
2025-09-01T04:31:05Z,pre_sentiment,gpt-4.1-mini,284,1,285
2025-09-01T04:31:08Z,sentiment,gpt-4.1-mini,2296,221,2517
2025-09-01T04:31:09Z,pre_sentiment,gpt-4.1-mini,290,1,291
2025-09-01T04:31:10Z,pre_sentiment,gpt-4.1-mini,280,1,281
2025-09-01T04:31:11Z,pre_sentiment,gpt-4.1-mini,284,1,285
2025-09-01T04:31:12Z,pre_sentiment,gpt-4.1-mini,292,1,293
2025-09-01T04:31:12Z,pre_sentiment,gpt-4.1-mini,286,1,287
2025-09-01T04:31:14Z,sentiment,gpt-4.1-mini,1664,164,1828
2025-09-01T04:31:17Z,pre_sentiment,gpt-4.1-mini,282,1,283
2025-09-01T04:31:17Z,pre_sentiment,gpt-4.1-mini,282,1,283
2025-09-01T04:31:17Z,pre_sentiment,gpt-4.1-mini,280,1,281
2025-09-01T04:31:18Z,pre_sentiment,gpt-4.1-mini,283,1,284
2025-09-01T04:31:18Z,pre_sentiment,gpt-4.1-mini,283,1,284
2025-09-01T04:31:22Z,sentiment,gpt-4.1-mini,2144,194,2338
2025-09-01T04:31:22Z,pre_sentiment,gpt-4.1-mini,289,1,290
2025-09-01T04:31:23Z,pre_sentiment,gpt-4.1-mini,284,1,285
2025-09-01T04:31:23Z,pre_sentiment,gpt-4.1-mini,282,1,283
2025-09-01T04:31:31Z,pre_sentiment,gpt-4.1-mini,280,1,281
2025-09-01T04:31:33Z,sentiment,gpt-4.1-mini,1288,182,1470
2025-09-01T04:31:34Z,pre_sentiment,gpt-4.1-mini,284,1,285
2025-09-01T04:31:34Z,pre_sentiment,gpt-4.1-mini,288,1,289
2025-09-01T04:31:37Z,sentiment,gpt-4.1-mini,2154,163,2317
2025-09-01T04:31:44Z,pre_sentiment,gpt-4.1-mini,282,1,283
2025-09-01T04:31:46Z,sentiment,gpt-4.1-mini,1584,134,1718
2025-09-01T04:31:51Z,pre_sentiment,gpt-4.1-mini,289,1,290
2025-09-01T04:31:53Z,sentiment,gpt-4.1-mini,1919,187,2106
2025-09-01T04:31:54Z,pre_sentiment,gpt-4.1-mini,281,1,282
2025-09-01T04:31:57Z,sentiment,gpt-4.1-mini,1691,234,1925
2025-09-01T04:31:58Z,pre_sentiment,gpt-4.1-mini,280,1,281
2025-09-01T04:31:58Z,pre_sentiment,gpt-4.1-mini,284,1,285
2025-09-01T04:31:59Z,pre_sentiment,gpt-4.1-mini,282,1,283
2025-09-01T04:32:02Z,sentiment,gpt-4.1-mini,1904,188,2092
2025-09-01T04:32:02Z,pre_sentiment,gpt-4.1-mini,285,1,286
2025-09-01T04:32:06Z,sentiment,gpt-4.1-mini,2464,213,2677
2025-09-01T04:32:06Z,pre_sentiment,gpt-4.1-mini,279,1,280
2025-09-01T04:32:11Z,sentiment,gpt-4.1-mini,1442,183,1625
2025-09-01T04:32:11Z,pre_sentiment,gpt-4.1-mini,282,1,283
2025-09-01T04:32:15Z,sentiment,gpt-4.1-mini,1645,214,1859
2025-09-01T04:32:15Z,pre_sentiment,gpt-4.1-mini,285,1,286
2025-09-01T04:32:18Z,sentiment,gpt-4.1-mini,1712,193,1905
2025-09-01T04:32:19Z,pre_sentiment,gpt-4.1-mini,286,1,287
2025-09-01T04:32:22Z,sentiment,gpt-4.1-mini,1655,204,1859
2025-09-01T04:32:22Z,pre_sentiment,gpt-4.1-mini,288,1,289
2025-09-01T04:32:25Z,sentiment,gpt-4.1-mini,1865,183,2048
2025-09-01T04:32:43Z,pre_sentiment,gpt-4.1-mini,299,1,300
2025-09-01T04:32:45Z,sentiment,gpt-4.1-mini,913,87,1000
2025-09-01T04:32:45Z,pre_sentiment,gpt-4.1-mini,295,1,296
2025-09-01T04:32:45Z,pre_sentiment,gpt-4.1-mini,300,1,301
2025-09-01T04:32:48Z,sentiment,gpt-4.1-mini,1004,166,1170
2025-09-01T04:32:48Z,pre_sentiment,gpt-4.1-mini,300,1,301
2025-09-01T04:32:49Z,sentiment,gpt-4.1-mini,1005,108,1113
2025-09-01T04:32:50Z,pre_sentiment,gpt-4.1-mini,298,1,299
2025-09-01T04:32:50Z,pre_sentiment,gpt-4.1-mini,301,1,302
2025-09-01T04:32:50Z,pre_sentiment,gpt-4.1-mini,294,1,295
2025-09-01T04:32:51Z,pre_sentiment,gpt-4.1-mini,304,1,305
2025-09-01T04:32:53Z,sentiment,gpt-4.1-mini,1972,138,2110
2025-09-01T04:32:53Z,pre_sentiment,gpt-4.1-mini,296,1,297
2025-09-01T04:32:55Z,sentiment,gpt-4.1-mini,921,90,1011
2025-09-01T04:32:55Z,pre_sentiment,gpt-4.1-mini,298,1,299
2025-09-01T04:32:55Z,pre_sentiment,gpt-4.1-mini,303,1,304
2025-09-01T04:33:25Z,pre_sentiment,gpt-4.1-mini,262,1,263
2025-09-01T04:33:29Z,pre_sentiment,gpt-4.1-mini,275,1,276
2025-09-01T04:33:31Z,sentiment,gpt-4.1-mini,1563,123,1686
2025-09-01T04:33:49Z,pre_sentiment,gpt-4.1-mini,279,1,280
2025-09-01T04:33:51Z,sentiment,gpt-4.1-mini,1679,134,1813
2025-09-01T04:33:52Z,pre_sentiment,gpt-4.1-mini,285,1,286
2025-09-01T04:33:54Z,sentiment,gpt-4.1-mini,2127,171,2298
2025-09-01T04:34:06Z,pre_sentiment,gpt-4.1-mini,279,1,280
2025-09-01T04:34:08Z,sentiment,gpt-4.1-mini,1679,134,1813
2025-09-01T04:34:15Z,pre_sentiment,gpt-4.1-mini,283,1,284
2025-09-01T04:34:18Z,sentiment,gpt-4.1-mini,2214,205,2419
2025-09-01T04:34:59Z,pre_sentiment,gpt-4.1-mini,287,1,288
2025-09-01T04:34:59Z,pre_sentiment,gpt-4.1-mini,286,1,287
2025-09-01T04:35:03Z,sentiment,gpt-4.1-mini,2019,198,2217
2025-09-01T04:35:29Z,article_selection,gpt-4.1-mini,840,16,856
2025-09-01T04:35:30Z,article_selection,gpt-4.1-mini,728,12,740
2025-09-01T04:35:30Z,article_selection,gpt-4.1-mini,675,9,684
2025-09-01T04:35:46Z,final_summary_en,gpt-4.1-mini,1458,1204,2662
2025-09-01T04:36:00Z,final_summary_en,gpt-4.1-mini,1176,1075,2251
2025-09-01T04:36:14Z,final_summary_en,gpt-4.1-mini,1970,1119,3089
2025-09-01T04:36:24Z,final_summary_en,gpt-4.1-mini,741,756,1497
2025-09-01T04:36:38Z,final_summary_en,gpt-4.1-mini,1888,1039,2927
2025-09-01T04:36:54Z,final_summary_en,gpt-4.1-mini,1459,1255,2714
2025-09-01T04:37:11Z,final_summary_en,gpt-4.1-mini,1412,1228,2640
2025-09-01T04:37:25Z,final_summary_en,gpt-4.1-mini,1616,1071,2687
2025-09-01T04:37:39Z,final_summary_en,gpt-4.1-mini,1644,1067,2711
2025-09-01T04:37:58Z,final_summary_en,gpt-4.1-mini,2225,1193,3418
2025-09-01T04:38:15Z,final_summary_en,gpt-4.1-mini,1869,1191,3060
2025-09-01T04:38:44Z,final_summary_en,gpt-4.1-mini,1763,1102,2865
2025-09-01T04:39:03Z,final_summary_en,gpt-4.1-mini,2065,1296,3361
2025-09-01T04:39:16Z,final_summary_en,gpt-4.1-mini,1040,929,1969
2025-09-01T04:40:09Z,category_summary,gpt-4.1-mini,129,40,169
2025-09-01T04:40:11Z,category_summary,gpt-4.1-mini,131,31,162
2025-09-01T04:40:13Z,category_summary,gpt-4.1-mini,84,17,101
2025-09-01T04:40:15Z,category_summary,gpt-4.1-mini,87,19,106
2025-09-01T04:40:17Z,category_summary,gpt-4.1-mini,132,43,175
2025-09-01T04:40:18Z,RUN_TOTAL,,83692,20172,103864
2025-09-02T04:26:27Z,pre_sentiment,gpt-4.1-mini,292,1,293
2025-09-02T04:26:27Z,pre_sentiment,gpt-4.1-mini,288,1,289
2025-09-02T04:26:28Z,pre_sentiment,gpt-4.1-mini,280,1,281
2025-09-02T04:26:32Z,sentiment,gpt-4.1-mini,1889,217,2106
2025-09-02T04:26:33Z,pre_sentiment,gpt-4.1-mini,288,1,289
2025-09-02T04:26:34Z,pre_sentiment,gpt-4.1-mini,279,1,280
2025-09-02T04:26:35Z,pre_sentiment,gpt-4.1-mini,280,1,281
2025-09-02T04:26:38Z,sentiment,gpt-4.1-mini,1334,158,1492
2025-09-02T04:26:39Z,pre_sentiment,gpt-4.1-mini,281,1,282
2025-09-02T04:26:39Z,pre_sentiment,gpt-4.1-mini,280,1,281
2025-09-02T04:26:40Z,pre_sentiment,gpt-4.1-mini,285,1,286
2025-09-02T04:26:43Z,sentiment,gpt-4.1-mini,1327,170,1497
2025-09-02T04:26:43Z,pre_sentiment,gpt-4.1-mini,281,1,282
2025-09-02T04:26:43Z,pre_sentiment,gpt-4.1-mini,290,1,291
2025-09-02T04:26:45Z,sentiment,gpt-4.1-mini,2213,125,2338
2025-09-02T04:26:45Z,pre_sentiment,gpt-4.1-mini,281,1,282
2025-09-02T04:26:46Z,pre_sentiment,gpt-4.1-mini,288,1,289
2025-09-02T04:26:46Z,pre_sentiment,gpt-4.1-mini,279,1,280
2025-09-02T04:26:49Z,sentiment,gpt-4.1-mini,2394,193,2587
2025-09-02T04:27:01Z,pre_sentiment,gpt-4.1-mini,281,1,282
2025-09-02T04:27:02Z,pre_sentiment,gpt-4.1-mini,286,1,287
2025-09-02T04:27:05Z,sentiment,gpt-4.1-mini,1242,201,1443
2025-09-02T04:27:06Z,pre_sentiment,gpt-4.1-mini,286,1,287
2025-09-02T04:27:06Z,pre_sentiment,gpt-4.1-mini,287,1,288
2025-09-02T04:27:13Z,pre_sentiment,gpt-4.1-mini,282,1,283
2025-09-02T04:27:19Z,pre_sentiment,gpt-4.1-mini,288,1,289
2025-09-02T04:27:23Z,sentiment,gpt-4.1-mini,2265,221,2486
2025-09-02T04:27:23Z,pre_sentiment,gpt-4.1-mini,281,1,282
2025-09-02T04:27:27Z,sentiment,gpt-4.1-mini,1679,214,1893
2025-09-02T04:27:27Z,pre_sentiment,gpt-4.1-mini,286,1,287
2025-09-02T04:27:30Z,sentiment,gpt-4.1-mini,1380,191,1571
2025-09-02T04:27:30Z,pre_sentiment,gpt-4.1-mini,285,1,286
2025-09-02T04:27:33Z,sentiment,gpt-4.1-mini,1895,185,2080
2025-09-02T04:27:34Z,pre_sentiment,gpt-4.1-mini,289,1,290
2025-09-02T04:27:37Z,sentiment,gpt-4.1-mini,1919,193,2112
2025-09-02T04:27:37Z,pre_sentiment,gpt-4.1-mini,285,1,286
2025-09-02T04:27:40Z,sentiment,gpt-4.1-mini,1770,212,1982
2025-09-02T04:27:40Z,pre_sentiment,gpt-4.1-mini,281,1,282
2025-09-02T04:27:43Z,sentiment,gpt-4.1-mini,1783,200,1983
2025-09-02T04:27:57Z,pre_sentiment,gpt-4.1-mini,294,1,295
2025-09-02T04:28:00Z,sentiment,gpt-4.1-mini,1218,128,1346
2025-09-02T04:28:00Z,pre_sentiment,gpt-4.1-mini,304,1,305
2025-09-02T04:28:03Z,sentiment,gpt-4.1-mini,1088,177,1265
2025-09-02T04:28:03Z,pre_sentiment,gpt-4.1-mini,298,1,299
2025-09-02T04:28:04Z,pre_sentiment,gpt-4.1-mini,301,1,302
2025-09-02T04:28:07Z,sentiment,gpt-4.1-mini,1663,231,1894
2025-09-02T04:28:07Z,pre_sentiment,gpt-4.1-mini,297,1,298
2025-09-02T04:28:10Z,sentiment,gpt-4.1-mini,2038,204,2242
2025-09-02T04:28:11Z,pre_sentiment,gpt-4.1-mini,300,1,301
2025-09-02T04:28:14Z,sentiment,gpt-4.1-mini,1437,211,1648
2025-09-02T04:28:14Z,pre_sentiment,gpt-4.1-mini,296,1,297
2025-09-02T04:28:17Z,sentiment,gpt-4.1-mini,1814,177,1991
2025-09-02T04:28:18Z,pre_sentiment,gpt-4.1-mini,299,1,300
2025-09-02T04:28:19Z,sentiment,gpt-4.1-mini,913,93,1006
2025-09-02T04:28:19Z,pre_sentiment,gpt-4.1-mini,295,1,296
2025-09-02T04:28:20Z,pre_sentiment,gpt-4.1-mini,300,1,301
2025-09-02T04:28:23Z,sentiment,gpt-4.1-mini,1005,147,1152
2025-09-02T04:28:24Z,pre_sentiment,gpt-4.1-mini,306,1,307
2025-09-02T04:28:24Z,pre_sentiment,gpt-4.1-mini,298,1,299
2025-09-02T04:28:48Z,pre_sentiment,gpt-4.1-mini,286,1,287
2025-09-02T04:28:52Z,sentiment,gpt-4.1-mini,1422,199,1621
2025-09-02T04:28:52Z,pre_sentiment,gpt-4.1-mini,286,1,287
2025-09-02T04:28:55Z,sentiment,gpt-4.1-mini,2046,164,2210
2025-09-02T04:29:19Z,pre_sentiment,gpt-4.1-mini,272,1,273
2025-09-02T04:29:20Z,pre_sentiment,gpt-4.1-mini,278,1,279
2025-09-02T04:29:23Z,sentiment,gpt-4.1-mini,2715,193,2908
2025-09-02T04:29:23Z,pre_sentiment,gpt-4.1-mini,274,1,275
2025-09-02T04:29:23Z,pre_sentiment,gpt-4.1-mini,287,1,288
2025-09-02T04:29:26Z,sentiment,gpt-4.1-mini,2636,138,2774
2025-09-02T04:29:26Z,pre_sentiment,gpt-4.1-mini,275,1,276
2025-09-02T04:29:28Z,sentiment,gpt-4.1-mini,1563,122,1685
2025-09-02T04:29:35Z,pre_sentiment,gpt-4.1-mini,286,1,287
2025-09-02T04:29:38Z,sentiment,gpt-4.1-mini,1601,181,1782
2025-09-02T04:29:39Z,pre_sentiment,gpt-4.1-mini,285,1,286
2025-09-02T04:29:41Z,sentiment,gpt-4.1-mini,1718,187,1905
2025-09-02T04:29:41Z,pre_sentiment,gpt-4.1-mini,285,1,286
2025-09-02T04:29:44Z,sentiment,gpt-4.1-mini,4288,184,4472
2025-09-02T04:29:44Z,pre_sentiment,gpt-4.1-mini,284,1,285
2025-09-02T04:29:47Z,sentiment,gpt-4.1-mini,1543,188,1731
2025-09-02T04:29:47Z,pre_sentiment,gpt-4.1-mini,286,1,287
2025-09-02T04:29:50Z,sentiment,gpt-4.1-mini,1881,142,2023
2025-09-02T04:30:05Z,pre_sentiment,gpt-4.1-mini,297,1,298
2025-09-02T04:30:05Z,pre_sentiment,gpt-4.1-mini,280,1,281
2025-09-02T04:30:24Z,pre_sentiment,gpt-4.1-mini,291,1,292
2025-09-02T04:30:26Z,sentiment,gpt-4.1-mini,1137,110,1247
2025-09-02T04:30:29Z,pre_sentiment,gpt-4.1-mini,297,1,298
2025-09-02T04:30:30Z,pre_sentiment,gpt-4.1-mini,280,1,281
2025-09-02T04:30:55Z,pre_sentiment,gpt-4.1-mini,291,1,292
2025-09-02T04:30:56Z,sentiment,gpt-4.1-mini,1566,125,1691
2025-09-02T04:30:57Z,pre_sentiment,gpt-4.1-mini,286,1,287
2025-09-02T04:31:00Z,sentiment,gpt-4.1-mini,1478,238,1716
2025-09-02T04:31:16Z,pre_sentiment,gpt-4.1-mini,282,1,283
2025-09-02T04:31:16Z,pre_sentiment,gpt-4.1-mini,284,1,285
2025-09-02T04:31:28Z,pre_sentiment,gpt-4.1-mini,288,1,289
2025-09-02T04:31:30Z,sentiment,gpt-4.1-mini,2593,167,2760
2025-09-02T04:31:31Z,pre_sentiment,gpt-4.1-mini,282,1,283
2025-09-02T04:31:41Z,pre_sentiment,gpt-4.1-mini,293,1,294
2025-09-02T04:31:42Z,pre_sentiment,gpt-4.1-mini,295,1,296
2025-09-02T04:31:46Z,sentiment,gpt-4.1-mini,1105,184,1289
2025-09-02T04:31:46Z,pre_sentiment,gpt-4.1-mini,285,1,286
2025-09-02T04:31:48Z,sentiment,gpt-4.1-mini,1106,144,1250
2025-09-02T04:31:49Z,pre_sentiment,gpt-4.1-mini,286,1,287
2025-09-02T04:31:51Z,sentiment,gpt-4.1-mini,1476,137,1613
2025-09-02T04:31:51Z,pre_sentiment,gpt-4.1-mini,282,1,283
2025-09-02T04:31:57Z,sentiment,gpt-4.1-mini,1245,206,1451
2025-09-02T04:31:57Z,pre_sentiment,gpt-4.1-mini,289,1,290
2025-09-02T04:32:01Z,sentiment,gpt-4.1-mini,1839,229,2068
2025-09-02T04:32:01Z,pre_sentiment,gpt-4.1-mini,285,1,286
2025-09-02T04:32:04Z,sentiment,gpt-4.1-mini,1202,126,1328
2025-09-02T04:32:04Z,pre_sentiment,gpt-4.1-mini,288,1,289
2025-09-02T04:32:07Z,sentiment,gpt-4.1-mini,1354,161,1515
2025-09-02T04:32:07Z,pre_sentiment,gpt-4.1-mini,283,1,284
2025-09-02T04:32:10Z,sentiment,gpt-4.1-mini,1205,190,1395
2025-09-02T04:32:10Z,pre_sentiment,gpt-4.1-mini,289,1,290
2025-09-02T04:32:11Z,pre_sentiment,gpt-4.1-mini,281,1,282
2025-09-02T04:32:11Z,pre_sentiment,gpt-4.1-mini,294,1,295
2025-09-02T04:32:11Z,pre_sentiment,gpt-4.1-mini,290,1,291
2025-09-02T04:32:15Z,sentiment,gpt-4.1-mini,1289,207,1496
2025-09-02T04:32:15Z,pre_sentiment,gpt-4.1-mini,285,1,286
2025-09-02T04:32:28Z,article_selection,gpt-4.1-mini,1147,12,1159
2025-09-02T04:32:29Z,article_selection,gpt-4.1-mini,2025,16,2041
2025-09-02T04:32:29Z,article_selection,gpt-4.1-mini,1065,12,1077
2025-09-02T04:32:30Z,article_selection,gpt-4.1-mini,711,12,723
2025-09-02T04:32:43Z,final_summary_en,gpt-4.1-mini,2031,933,2964
2025-09-02T04:33:00Z,final_summary_en,gpt-4.1-mini,1121,1179,2300
2025-09-02T04:33:17Z,final_summary_en,gpt-4.1-mini,1433,1176,2609
2025-09-02T04:33:32Z,final_summary_en,gpt-4.1-mini,1350,836,2186
2025-09-02T04:33:46Z,final_summary_en,gpt-4.1-mini,1187,872,2059
2025-09-02T04:34:04Z,final_summary_en,gpt-4.1-mini,1013,1131,2144
2025-09-02T04:34:23Z,final_summary_en,gpt-4.1-mini,2158,1220,3378
2025-09-02T04:34:43Z,final_summary_en,gpt-4.1-mini,2470,1176,3646
2025-09-02T04:34:59Z,final_summary_en,gpt-4.1-mini,1035,1190,2225
2025-09-02T04:35:14Z,final_summary_en,gpt-4.1-mini,832,992,1824
2025-09-02T04:35:30Z,final_summary_en,gpt-4.1-mini,1169,1049,2218
2025-09-02T04:35:49Z,final_summary_en,gpt-4.1-mini,1259,1256,2515
2025-09-02T04:36:06Z,final_summary_en,gpt-4.1-mini,1639,1170,2809
2025-09-02T04:36:25Z,final_summary_en,gpt-4.1-mini,1536,1180,2716
2025-09-02T04:36:42Z,final_summary_en,gpt-4.1-mini,1291,957,2248
2025-09-02T04:36:59Z,final_summary_en,gpt-4.1-mini,1526,1239,2765
2025-09-02T04:37:49Z,category_summary,gpt-4.1-mini,137,42,179
2025-09-02T04:37:51Z,category_summary,gpt-4.1-mini,143,36,179
2025-09-02T04:37:53Z,category_summary,gpt-4.1-mini,134,34,168
2025-09-02T04:37:55Z,category_summary,gpt-4.1-mini,125,32,157
2025-09-02T04:37:56Z,RUN_TOTAL,,124355,25597,149952
2025-09-03T04:25:31Z,pre_sentiment,gpt-4.1-mini,279,1,280
2025-09-03T04:25:34Z,sentiment,gpt-4.1-mini,1226,179,1405
2025-09-03T04:25:35Z,pre_sentiment,gpt-4.1-mini,285,1,286
2025-09-03T04:25:35Z,pre_sentiment,gpt-4.1-mini,282,1,283
2025-09-03T04:25:36Z,pre_sentiment,gpt-4.1-mini,279,1,280
2025-09-03T04:25:36Z,pre_sentiment,gpt-4.1-mini,282,1,283
2025-09-03T04:25:37Z,pre_sentiment,gpt-4.1-mini,284,1,285
2025-09-03T04:25:38Z,pre_sentiment,gpt-4.1-mini,284,1,285
2025-09-03T04:25:39Z,pre_sentiment,gpt-4.1-mini,282,1,283
2025-09-03T04:25:42Z,pre_sentiment,gpt-4.1-mini,284,1,285
2025-09-03T04:25:42Z,pre_sentiment,gpt-4.1-mini,286,1,287
2025-09-03T04:25:43Z,pre_sentiment,gpt-4.1-mini,286,1,287
2025-09-03T04:25:43Z,pre_sentiment,gpt-4.1-mini,285,1,286
2025-09-03T04:25:43Z,pre_sentiment,gpt-4.1-mini,286,1,287
2025-09-03T04:25:50Z,pre_sentiment,gpt-4.1-mini,283,1,284
2025-09-03T04:25:50Z,pre_sentiment,gpt-4.1-mini,286,1,287
2025-09-03T04:25:53Z,sentiment,gpt-4.1-mini,1300,143,1443
2025-09-03T04:25:53Z,pre_sentiment,gpt-4.1-mini,282,1,283
2025-09-03T04:26:05Z,pre_sentiment,gpt-4.1-mini,285,1,286
2025-09-03T04:26:08Z,sentiment,gpt-4.1-mini,1784,222,2006
2025-09-03T04:26:09Z,pre_sentiment,gpt-4.1-mini,278,1,279
2025-09-03T04:26:11Z,sentiment,gpt-4.1-mini,1371,182,1553
2025-09-03T04:26:11Z,pre_sentiment,gpt-4.1-mini,284,1,285
2025-09-03T04:26:15Z,sentiment,gpt-4.1-mini,1937,199,2136
2025-09-03T04:26:15Z,pre_sentiment,gpt-4.1-mini,301,1,302
2025-09-03T04:26:18Z,sentiment,gpt-4.1-mini,1419,187,1606
2025-09-03T04:26:18Z,pre_sentiment,gpt-4.1-mini,298,1,299
2025-09-03T04:26:21Z,sentiment,gpt-4.1-mini,1354,188,1542
2025-09-03T04:26:21Z,pre_sentiment,gpt-4.1-mini,275,1,276
2025-09-03T04:26:25Z,sentiment,gpt-4.1-mini,1255,217,1472
2025-09-03T04:26:26Z,pre_sentiment,gpt-4.1-mini,283,1,284
2025-09-03T04:26:29Z,sentiment,gpt-4.1-mini,1703,216,1919
2025-09-03T04:26:29Z,pre_sentiment,gpt-4.1-mini,287,1,288
2025-09-03T04:26:32Z,sentiment,gpt-4.1-mini,1450,145,1595
2025-09-03T04:26:32Z,pre_sentiment,gpt-4.1-mini,282,1,283
2025-09-03T04:26:35Z,sentiment,gpt-4.1-mini,1307,162,1469
2025-09-03T04:26:35Z,pre_sentiment,gpt-4.1-mini,285,1,286
2025-09-03T04:26:38Z,sentiment,gpt-4.1-mini,1455,191,1646
2025-09-03T04:26:38Z,pre_sentiment,gpt-4.1-mini,286,1,287
2025-09-03T04:26:55Z,pre_sentiment,gpt-4.1-mini,300,1,301
2025-09-03T04:26:56Z,sentiment,gpt-4.1-mini,916,99,1015
2025-09-03T04:26:57Z,pre_sentiment,gpt-4.1-mini,295,1,296
2025-09-03T04:26:58Z,sentiment,gpt-4.1-mini,905,95,1000
2025-09-03T04:26:59Z,pre_sentiment,gpt-4.1-mini,298,1,299
2025-09-03T04:26:59Z,pre_sentiment,gpt-4.1-mini,295,1,296
2025-09-03T04:27:01Z,sentiment,gpt-4.1-mini,931,92,1023
2025-09-03T04:27:01Z,pre_sentiment,gpt-4.1-mini,289,1,290
2025-09-03T04:27:03Z,sentiment,gpt-4.1-mini,896,93,989
2025-09-03T04:27:03Z,pre_sentiment,gpt-4.1-mini,298,1,299
2025-09-03T04:27:04Z,sentiment,gpt-4.1-mini,909,102,1011
2025-09-03T04:27:05Z,pre_sentiment,gpt-4.1-mini,297,1,298
2025-09-03T04:27:08Z,sentiment,gpt-4.1-mini,2980,235,3215
2025-09-03T04:27:08Z,pre_sentiment,gpt-4.1-mini,300,1,301
2025-09-03T04:27:12Z,sentiment,gpt-4.1-mini,2133,213,2346
2025-09-03T04:27:12Z,pre_sentiment,gpt-4.1-mini,298,1,299
2025-09-03T04:27:17Z,sentiment,gpt-4.1-mini,1290,194,1484
2025-09-03T04:27:17Z,pre_sentiment,gpt-4.1-mini,297,1,298
2025-09-03T04:27:20Z,sentiment,gpt-4.1-mini,1344,198,1542
2025-09-03T04:27:20Z,pre_sentiment,gpt-4.1-mini,297,1,298
2025-09-03T04:27:23Z,sentiment,gpt-4.1-mini,2626,163,2789
2025-09-03T04:27:23Z,pre_sentiment,gpt-4.1-mini,300,1,301
2025-09-03T04:27:25Z,sentiment,gpt-4.1-mini,1627,159,1786
2025-09-03T04:27:27Z,pre_sentiment,gpt-4.1-mini,294,1,295
2025-09-03T04:27:28Z,sentiment,gpt-4.1-mini,1218,119,1337
2025-09-03T04:27:29Z,pre_sentiment,gpt-4.1-mini,298,1,299
2025-09-03T04:27:47Z,pre_sentiment,gpt-4.1-mini,288,1,289
2025-09-03T04:27:50Z,sentiment,gpt-4.1-mini,1526,196,1722
2025-09-03T04:27:50Z,pre_sentiment,gpt-4.1-mini,266,1,267
2025-09-03T04:27:53Z,sentiment,gpt-4.1-mini,7756,171,7927
2025-09-03T04:27:53Z,pre_sentiment,gpt-4.1-mini,279,1,280
2025-09-03T04:27:57Z,sentiment,gpt-4.1-mini,1110,164,1274
2025-09-03T04:27:58Z,pre_sentiment,gpt-4.1-mini,278,1,279
2025-09-03T04:28:00Z,sentiment,gpt-4.1-mini,1334,133,1467
2025-09-03T04:28:01Z,pre_sentiment,gpt-4.1-mini,288,1,289
2025-09-03T04:28:03Z,sentiment,gpt-4.1-mini,1511,139,1650
2025-09-03T04:28:04Z,pre_sentiment,gpt-4.1-mini,282,1,283
2025-09-03T04:28:06Z,sentiment,gpt-4.1-mini,991,134,1125
2025-09-03T04:28:06Z,pre_sentiment,gpt-4.1-mini,290,1,291
2025-09-03T04:28:10Z,sentiment,gpt-4.1-mini,2751,218,2969
2025-09-03T04:28:10Z,pre_sentiment,gpt-4.1-mini,287,1,288
2025-09-03T04:28:13Z,sentiment,gpt-4.1-mini,2076,220,2296
2025-09-03T04:28:18Z,pre_sentiment,gpt-4.1-mini,284,1,285
2025-09-03T04:28:20Z,sentiment,gpt-4.1-mini,1885,159,2044
2025-09-03T04:28:20Z,pre_sentiment,gpt-4.1-mini,286,1,287
2025-09-03T04:28:23Z,sentiment,gpt-4.1-mini,2631,206,2837
2025-09-03T04:28:33Z,pre_sentiment,gpt-4.1-mini,285,1,286
2025-09-03T04:28:38Z,sentiment,gpt-4.1-mini,3488,255,3743
2025-09-03T04:28:38Z,pre_sentiment,gpt-4.1-mini,274,1,275
2025-09-03T04:28:43Z,pre_sentiment,gpt-4.1-mini,274,1,275
2025-09-03T04:28:43Z,pre_sentiment,gpt-4.1-mini,289,1,290
2025-09-03T04:28:43Z,pre_sentiment,gpt-4.1-mini,280,1,281
2025-09-03T04:28:44Z,pre_sentiment,gpt-4.1-mini,275,1,276
2025-09-03T04:28:44Z,pre_sentiment,gpt-4.1-mini,275,1,276
2025-09-03T04:28:44Z,pre_sentiment,gpt-4.1-mini,274,1,275
2025-09-03T04:28:52Z,pre_sentiment,gpt-4.1-mini,280,1,281
2025-09-03T04:28:56Z,sentiment,gpt-4.1-mini,1622,218,1840
2025-09-03T04:28:56Z,pre_sentiment,gpt-4.1-mini,286,1,287
2025-09-03T04:28:59Z,sentiment,gpt-4.1-mini,1659,204,1863
2025-09-03T04:29:00Z,pre_sentiment,gpt-4.1-mini,287,1,288
2025-09-03T04:29:00Z,pre_sentiment,gpt-4.1-mini,281,1,282
2025-09-03T04:29:03Z,sentiment,gpt-4.1-mini,1659,182,1841
2025-09-03T04:29:03Z,pre_sentiment,gpt-4.1-mini,286,1,287
2025-09-03T04:29:24Z,pre_sentiment,gpt-4.1-mini,291,1,292
2025-09-03T04:29:26Z,sentiment,gpt-4.1-mini,1104,114,1218
2025-09-03T04:29:38Z,pre_sentiment,gpt-4.1-mini,286,1,287
2025-09-03T04:31:26Z,pre_sentiment,gpt-4.1-mini,291,1,292
2025-09-03T04:31:29Z,sentiment,gpt-4.1-mini,1566,120,1686
2025-09-03T04:31:38Z,pre_sentiment,gpt-4.1-mini,283,1,284
2025-09-03T04:31:39Z,pre_sentiment,gpt-4.1-mini,281,1,282
2025-09-03T04:31:41Z,sentiment,gpt-4.1-mini,1435,166,1601
2025-09-03T04:31:41Z,pre_sentiment,gpt-4.1-mini,280,1,281
2025-09-03T04:31:42Z,pre_sentiment,gpt-4.1-mini,282,1,283
2025-09-03T04:31:42Z,pre_sentiment,gpt-4.1-mini,283,1,284
2025-09-03T04:31:42Z,pre_sentiment,gpt-4.1-mini,280,1,281
2025-09-03T04:31:43Z,pre_sentiment,gpt-4.1-mini,289,1,290
2025-09-03T04:31:45Z,sentiment,gpt-4.1-mini,1398,151,1549
2025-09-03T04:31:59Z,pre_sentiment,gpt-4.1-mini,291,1,292
2025-09-03T04:32:02Z,sentiment,gpt-4.1-mini,2703,235,2938
2025-09-03T04:32:02Z,pre_sentiment,gpt-4.1-mini,290,1,291
2025-09-03T04:32:16Z,pre_sentiment,gpt-4.1-mini,296,1,297
2025-09-03T04:32:17Z,pre_sentiment,gpt-4.1-mini,272,1,273
2025-09-03T04:32:19Z,sentiment,gpt-4.1-mini,1190,196,1386
2025-09-03T04:32:20Z,pre_sentiment,gpt-4.1-mini,282,1,283
2025-09-03T04:32:22Z,sentiment,gpt-4.1-mini,1265,165,1430
2025-09-03T04:32:22Z,pre_sentiment,gpt-4.1-mini,285,1,286
2025-09-03T04:32:24Z,sentiment,gpt-4.1-mini,1263,142,1405
2025-09-03T04:32:24Z,pre_sentiment,gpt-4.1-mini,290,1,291
2025-09-03T04:32:25Z,pre_sentiment,gpt-4.1-mini,282,1,283
2025-09-03T04:32:25Z,pre_sentiment,gpt-4.1-mini,288,1,289
2025-09-03T04:32:26Z,pre_sentiment,gpt-4.1-mini,289,1,290
2025-09-03T04:32:26Z,pre_sentiment,gpt-4.1-mini,279,1,280
2025-09-03T04:32:27Z,pre_sentiment,gpt-4.1-mini,286,1,287
2025-09-03T04:32:36Z,article_selection,gpt-4.1-mini,1013,16,1029
2025-09-03T04:32:37Z,article_selection,gpt-4.1-mini,932,12,944
2025-09-03T04:32:37Z,article_selection,gpt-4.1-mini,785,12,797
2025-09-03T04:32:38Z,article_selection,gpt-4.1-mini,964,12,976
2025-09-03T04:32:38Z,article_selection,gpt-4.1-mini,606,16,622
2025-09-03T04:32:49Z,final_summary_en,gpt-4.1-mini,1186,1082,2268
2025-09-03T04:32:59Z,final_summary_en,gpt-4.1-mini,1041,1150,2191
2025-09-03T04:33:08Z,final_summary_en,gpt-4.1-mini,974,1087,2061
2025-09-03T04:33:15Z,final_summary_en,gpt-4.1-mini,1025,1013,2038
2025-09-03T04:33:25Z,final_summary_en,gpt-4.1-mini,2733,1004,3737
2025-09-03T04:33:38Z,final_summary_en,gpt-4.1-mini,2396,1461,3857
2025-09-03T04:33:52Z,final_summary_en,gpt-4.1-mini,3246,1503,4749
2025-09-03T04:34:04Z,final_summary_en,gpt-4.1-mini,1392,1388,2780
2025-09-03T04:34:14Z,final_summary_en,gpt-4.1-mini,1551,1174,2725
2025-09-03T04:34:25Z,final_summary_en,gpt-4.1-mini,1677,1236,2913
2025-09-03T04:34:37Z,final_summary_en,gpt-4.1-mini,2504,1365,3869
2025-09-03T04:34:47Z,final_summary_en,gpt-4.1-mini,1287,1230,2517
2025-09-03T04:34:57Z,final_summary_en,gpt-4.1-mini,1046,1260,2306
2025-09-03T04:35:05Z,final_summary_en,gpt-4.1-mini,1902,1053,2955
2025-09-03T04:35:13Z,final_summary_en,gpt-4.1-mini,1843,1074,2917
2025-09-03T04:35:24Z,final_summary_en,gpt-4.1-mini,1102,1092,2194
2025-09-03T04:35:36Z,final_summary_en,gpt-4.1-mini,1161,1113,2274
2025-09-03T04:35:46Z,final_summary_en,gpt-4.1-mini,2479,1166,3645
2025-09-03T04:35:56Z,final_summary_en,gpt-4.1-mini,958,1201,2159
2025-09-03T04:36:05Z,final_summary_en,gpt-4.1-mini,1001,1047,2048
2025-09-03T04:37:07Z,category_summary,gpt-4.1-mini,125,41,166
2025-09-03T04:37:10Z,category_summary,gpt-4.1-mini,133,35,168
2025-09-03T04:37:11Z,category_summary,gpt-4.1-mini,135,33,168
2025-09-03T04:37:13Z,category_summary,gpt-4.1-mini,140,39,179
2025-09-03T04:37:16Z,category_summary,gpt-4.1-mini,140,38,178
2025-09-03T04:37:17Z,RUN_TOTAL,,141321,31920,173241
2025-09-04T04:24:07Z,pre_sentiment,gpt-4.1-mini,279,1,280
2025-09-04T04:24:08Z,pre_sentiment,gpt-4.1-mini,281,1,282
2025-09-04T04:24:09Z,pre_sentiment,gpt-4.1-mini,296,1,297
2025-09-04T04:24:09Z,pre_sentiment,gpt-4.1-mini,285,1,286
2025-09-04T04:24:09Z,pre_sentiment,gpt-4.1-mini,290,1,291
2025-09-04T04:24:10Z,pre_sentiment,gpt-4.1-mini,289,1,290
2025-09-04T04:24:11Z,pre_sentiment,gpt-4.1-mini,281,1,282
2025-09-04T04:24:14Z,sentiment,gpt-4.1-mini,1911,182,2093
2025-09-04T04:24:14Z,pre_sentiment,gpt-4.1-mini,284,1,285
2025-09-04T04:24:15Z,pre_sentiment,gpt-4.1-mini,283,1,284
2025-09-04T04:24:16Z,pre_sentiment,gpt-4.1-mini,288,1,289
2025-09-04T04:24:16Z,pre_sentiment,gpt-4.1-mini,294,1,295
2025-09-04T04:24:16Z,pre_sentiment,gpt-4.1-mini,287,1,288
2025-09-04T04:24:17Z,pre_sentiment,gpt-4.1-mini,292,1,293
2025-09-04T04:24:17Z,pre_sentiment,gpt-4.1-mini,284,1,285
2025-09-04T04:24:18Z,pre_sentiment,gpt-4.1-mini,288,1,289
2025-09-04T04:24:23Z,pre_sentiment,gpt-4.1-mini,281,1,282
2025-09-04T04:24:23Z,pre_sentiment,gpt-4.1-mini,279,1,280
2025-09-04T04:24:24Z,pre_sentiment,gpt-4.1-mini,285,1,286
2025-09-04T04:24:24Z,pre_sentiment,gpt-4.1-mini,284,1,285
2025-09-04T04:24:24Z,pre_sentiment,gpt-4.1-mini,289,1,290
2025-09-04T04:24:36Z,pre_sentiment,gpt-4.1-mini,282,1,283
2025-09-04T04:24:39Z,sentiment,gpt-4.1-mini,1969,233,2202
2025-09-04T04:24:39Z,pre_sentiment,gpt-4.1-mini,282,1,283
2025-09-04T04:24:42Z,sentiment,gpt-4.1-mini,1933,192,2125
2025-09-04T04:24:43Z,pre_sentiment,gpt-4.1-mini,284,1,285
2025-09-04T04:24:45Z,sentiment,gpt-4.1-mini,1452,176,1628
2025-09-04T04:24:46Z,pre_sentiment,gpt-4.1-mini,283,1,284
2025-09-04T04:24:46Z,pre_sentiment,gpt-4.1-mini,279,1,280
2025-09-04T04:24:47Z,pre_sentiment,gpt-4.1-mini,287,1,288
2025-09-04T04:24:52Z,sentiment,gpt-4.1-mini,2252,196,2448
2025-09-04T04:24:52Z,pre_sentiment,gpt-4.1-mini,276,1,277
2025-09-04T04:24:56Z,sentiment,gpt-4.1-mini,2467,262,2729
2025-09-04T04:24:56Z,pre_sentiment,gpt-4.1-mini,282,1,283
2025-09-04T04:24:56Z,pre_sentiment,gpt-4.1-mini,278,1,279
2025-09-04T04:24:59Z,sentiment,gpt-4.1-mini,1371,184,1555
2025-09-04T04:25:16Z,pre_sentiment,gpt-4.1-mini,303,1,304
2025-09-04T04:25:18Z,sentiment,gpt-4.1-mini,1146,190,1336
2025-09-04T04:25:19Z,pre_sentiment,gpt-4.1-mini,294,1,295
2025-09-04T04:25:22Z,sentiment,gpt-4.1-mini,1405,194,1599
2025-09-04T04:25:23Z,pre_sentiment,gpt-4.1-mini,300,1,301
2025-09-04T04:25:27Z,sentiment,gpt-4.1-mini,965,170,1135
2025-09-04T04:25:27Z,pre_sentiment,gpt-4.1-mini,289,1,290
2025-09-04T04:25:30Z,sentiment,gpt-4.1-mini,990,175,1165
2025-09-04T04:25:30Z,pre_sentiment,gpt-4.1-mini,291,1,292
2025-09-04T04:25:32Z,sentiment,gpt-4.1-mini,908,98,1006
2025-09-04T04:25:32Z,pre_sentiment,gpt-4.1-mini,296,1,297
2025-09-04T04:25:36Z,sentiment,gpt-4.1-mini,6234,209,6443
2025-09-04T04:25:37Z,pre_sentiment,gpt-4.1-mini,298,1,299
2025-09-04T04:25:40Z,sentiment,gpt-4.1-mini,5570,185,5755
2025-09-04T04:25:40Z,pre_sentiment,gpt-4.1-mini,295,1,296
2025-09-04T04:25:44Z,sentiment,gpt-4.1-mini,5160,257,5417
2025-09-04T04:25:45Z,pre_sentiment,gpt-4.1-mini,294,1,295
2025-09-04T04:25:52Z,sentiment,gpt-4.1-mini,12856,266,13122
2025-09-04T04:25:52Z,pre_sentiment,gpt-4.1-mini,298,1,299
2025-09-04T04:25:56Z,sentiment,gpt-4.1-mini,5657,159,5816
2025-09-04T04:25:56Z,pre_sentiment,gpt-4.1-mini,293,1,294
2025-09-04T04:26:00Z,sentiment,gpt-4.1-mini,5812,196,6008
2025-09-04T04:26:01Z,pre_sentiment,gpt-4.1-mini,297,1,298
2025-09-04T04:26:04Z,sentiment,gpt-4.1-mini,8754,213,8967
2025-09-04T04:26:04Z,pre_sentiment,gpt-4.1-mini,296,1,297
2025-09-04T04:26:07Z,sentiment,gpt-4.1-mini,6901,205,7106
2025-09-04T04:26:07Z,pre_sentiment,gpt-4.1-mini,297,1,298
2025-09-04T04:26:11Z,sentiment,gpt-4.1-mini,6956,226,7182
2025-09-04T04:26:12Z,pre_sentiment,gpt-4.1-mini,299,1,300
2025-09-04T04:26:15Z,sentiment,gpt-4.1-mini,7907,199,8106
2025-09-04T04:26:34Z,pre_sentiment,gpt-4.1-mini,283,1,284
2025-09-04T04:26:34Z,pre_sentiment,gpt-4.1-mini,279,1,280
2025-09-04T04:26:36Z,sentiment,gpt-4.1-mini,1221,133,1354
2025-09-04T04:26:37Z,pre_sentiment,gpt-4.1-mini,285,1,286
2025-09-04T04:26:39Z,sentiment,gpt-4.1-mini,1291,136,1427
2025-09-04T04:26:39Z,pre_sentiment,gpt-4.1-mini,266,1,267
2025-09-04T04:26:42Z,sentiment,gpt-4.1-mini,7756,170,7926
2025-09-04T04:26:47Z,pre_sentiment,gpt-4.1-mini,291,1,292
2025-09-04T04:26:51Z,sentiment,gpt-4.1-mini,1295,190,1485
2025-09-04T04:26:51Z,pre_sentiment,gpt-4.1-mini,287,1,288
2025-09-04T04:26:54Z,sentiment,gpt-4.1-mini,2169,170,2339
2025-09-04T04:27:13Z,pre_sentiment,gpt-4.1-mini,266,1,267
2025-09-04T04:27:16Z,sentiment,gpt-4.1-mini,2198,209,2407
2025-09-04T04:27:16Z,pre_sentiment,gpt-4.1-mini,283,1,284
2025-09-04T04:27:20Z,sentiment,gpt-4.1-mini,5868,225,6093
2025-09-04T04:27:21Z,pre_sentiment,gpt-4.1-mini,269,1,270
2025-09-04T04:27:21Z,pre_sentiment,gpt-4.1-mini,259,1,260
2025-09-04T04:27:25Z,pre_sentiment,gpt-4.1-mini,273,1,274
2025-09-04T04:27:28Z,sentiment,gpt-4.1-mini,3096,221,3317
2025-09-04T04:27:29Z,pre_sentiment,gpt-4.1-mini,278,1,279
2025-09-04T04:27:29Z,pre_sentiment,gpt-4.1-mini,278,1,279
2025-09-04T04:27:30Z,pre_sentiment,gpt-4.1-mini,273,1,274
2025-09-04T04:27:30Z,pre_sentiment,gpt-4.1-mini,274,1,275
2025-09-04T04:27:31Z,pre_sentiment,gpt-4.1-mini,280,1,281
2025-09-04T04:27:37Z,pre_sentiment,gpt-4.1-mini,287,1,288
2025-09-04T04:27:39Z,sentiment,gpt-4.1-mini,1715,184,1899
2025-09-04T04:27:39Z,pre_sentiment,gpt-4.1-mini,284,1,285
2025-09-04T04:27:42Z,sentiment,gpt-4.1-mini,1501,198,1699
2025-09-04T04:27:43Z,pre_sentiment,gpt-4.1-mini,285,1,286
2025-09-04T04:27:43Z,pre_sentiment,gpt-4.1-mini,284,1,285
2025-09-04T04:27:43Z,pre_sentiment,gpt-4.1-mini,288,1,289
2025-09-04T04:27:46Z,sentiment,gpt-4.1-mini,1474,201,1675
2025-09-04T04:27:47Z,pre_sentiment,gpt-4.1-mini,284,1,285
2025-09-04T04:27:47Z,pre_sentiment,gpt-4.1-mini,287,1,288
2025-09-04T04:27:50Z,sentiment,gpt-4.1-mini,1936,176,2112
2025-09-04T04:27:50Z,pre_sentiment,gpt-4.1-mini,283,1,284
2025-09-04T04:27:53Z,sentiment,gpt-4.1-mini,1800,196,1996
2025-09-04T04:27:53Z,pre_sentiment,gpt-4.1-mini,282,1,283
2025-09-04T04:27:57Z,sentiment,gpt-4.1-mini,3870,270,4140
2025-09-04T04:28:19Z,pre_sentiment,gpt-4.1-mini,288,1,289
2025-09-04T04:28:19Z,pre_sentiment,gpt-4.1-mini,288,1,289
2025-09-04T04:28:21Z,sentiment,gpt-4.1-mini,1498,131,1629
2025-09-04T04:28:33Z,pre_sentiment,gpt-4.1-mini,283,1,284
2025-09-04T04:28:34Z,pre_sentiment,gpt-4.1-mini,292,1,293
2025-09-04T04:28:36Z,sentiment,gpt-4.1-mini,1111,113,1224
2025-09-04T04:28:36Z,pre_sentiment,gpt-4.1-mini,283,1,284
2025-09-04T04:28:37Z,pre_sentiment,gpt-4.1-mini,278,1,279
2025-09-04T04:28:44Z,pre_sentiment,gpt-4.1-mini,296,1,297
2025-09-04T04:28:46Z,sentiment,gpt-4.1-mini,1637,141,1778
2025-09-04T04:28:46Z,pre_sentiment,gpt-4.1-mini,290,1,291
2025-09-04T04:28:49Z,sentiment,gpt-4.1-mini,1601,220,1821
2025-09-04T04:28:50Z,pre_sentiment,gpt-4.1-mini,285,1,286
2025-09-04T04:28:52Z,sentiment,gpt-4.1-mini,1617,179,1796
2025-09-04T04:28:53Z,pre_sentiment,gpt-4.1-mini,289,1,290
2025-09-04T04:28:55Z,sentiment,gpt-4.1-mini,1786,138,1924
2025-09-04T04:29:04Z,pre_sentiment,gpt-4.1-mini,284,1,285
2025-09-04T04:29:07Z,sentiment,gpt-4.1-mini,1509,202,1711
2025-09-04T04:29:11Z,pre_sentiment,gpt-4.1-mini,286,1,287
2025-09-04T04:29:11Z,pre_sentiment,gpt-4.1-mini,303,1,304
2025-09-04T04:29:12Z,pre_sentiment,gpt-4.1-mini,284,1,285
2025-09-04T04:29:14Z,sentiment,gpt-4.1-mini,1361,197,1558
2025-09-04T04:29:15Z,pre_sentiment,gpt-4.1-mini,290,1,291
2025-09-04T04:29:15Z,pre_sentiment,gpt-4.1-mini,288,1,289
2025-09-04T04:29:18Z,sentiment,gpt-4.1-mini,1647,201,1848
2025-09-04T04:29:18Z,pre_sentiment,gpt-4.1-mini,280,1,281
2025-09-04T04:29:18Z,pre_sentiment,gpt-4.1-mini,289,1,290
2025-09-04T04:29:30Z,pre_sentiment,gpt-4.1-mini,288,1,289
2025-09-04T04:29:30Z,pre_sentiment,gpt-4.1-mini,285,1,286
2025-09-04T04:29:41Z,pre_sentiment,gpt-4.1-mini,293,1,294
2025-09-04T04:29:42Z,pre_sentiment,gpt-4.1-mini,289,1,290
2025-09-04T04:29:42Z,pre_sentiment,gpt-4.1-mini,291,1,292
2025-09-04T04:29:42Z,pre_sentiment,gpt-4.1-mini,281,1,282
2025-09-04T04:29:46Z,sentiment,gpt-4.1-mini,1836,193,2029
2025-09-04T04:29:46Z,pre_sentiment,gpt-4.1-mini,265,1,266
2025-09-04T04:29:48Z,sentiment,gpt-4.1-mini,1281,180,1461
2025-09-04T04:29:49Z,pre_sentiment,gpt-4.1-mini,300,1,301
2025-09-04T04:29:49Z,pre_sentiment,gpt-4.1-mini,288,1,289
2025-09-04T04:29:53Z,sentiment,gpt-4.1-mini,1960,277,2237
2025-09-04T04:29:53Z,pre_sentiment,gpt-4.1-mini,306,1,307
2025-09-04T04:29:54Z,pre_sentiment,gpt-4.1-mini,288,1,289
2025-09-04T04:29:54Z,pre_sentiment,gpt-4.1-mini,282,1,283
2025-09-04T04:29:56Z,sentiment,gpt-4.1-mini,1254,197,1451
2025-09-04T04:29:57Z,pre_sentiment,gpt-4.1-mini,280,1,281
2025-09-04T04:29:59Z,sentiment,gpt-4.1-mini,1170,161,1331
2025-09-04T04:29:59Z,pre_sentiment,gpt-4.1-mini,284,1,285
2025-09-04T04:30:02Z,sentiment,gpt-4.1-mini,1294,172,1466
2025-09-04T04:30:02Z,pre_sentiment,gpt-4.1-mini,285,1,286
2025-09-04T04:30:07Z,sentiment,gpt-4.1-mini,1314,143,1457
2025-09-04T04:30:08Z,pre_sentiment,gpt-4.1-mini,283,1,284
2025-09-04T04:30:08Z,pre_sentiment,gpt-4.1-mini,282,1,283
2025-09-04T04:30:10Z,sentiment,gpt-4.1-mini,1185,144,1329
2025-09-04T04:30:21Z,article_selection,gpt-4.1-mini,1231,12,1243
2025-09-04T04:30:21Z,article_selection,gpt-4.1-mini,1510,12,1522
2025-09-04T04:30:22Z,article_selection,gpt-4.1-mini,464,10,474
2025-09-04T04:30:22Z,article_selection,gpt-4.1-mini,1008,9,1017
2025-09-04T04:30:23Z,article_selection,gpt-4.1-mini,905,12,917
2025-09-04T04:30:25Z,article_selection,gpt-4.1-mini,2139,16,2155
2025-09-04T04:30:39Z,final_summary_en,gpt-4.1-mini,2237,916,3153
2025-09-04T04:30:59Z,final_summary_en,gpt-4.1-mini,1351,1391,2742
2025-09-04T04:31:18Z,final_summary_en,gpt-4.1-mini,4935,1372,6307
2025-09-04T04:31:38Z,final_summary_en,gpt-4.1-mini,1170,1168,2338
2025-09-04T04:31:59Z,final_summary_en,gpt-4.1-mini,2004,1432,3436
2025-09-04T04:32:17Z,final_summary_en,gpt-4.1-mini,3639,1259,4898
2025-09-04T04:32:31Z,final_summary_en,gpt-4.1-mini,1193,984,2177
2025-09-04T04:32:44Z,final_summary_en,gpt-4.1-mini,727,932,1659
2025-09-04T04:33:02Z,final_summary_en,gpt-4.1-mini,1746,1142,2888
2025-09-04T04:33:22Z,final_summary_en,gpt-4.1-mini,1674,1231,2905
2025-09-04T04:33:48Z,final_summary_en,gpt-4.1-mini,6000,1228,7228
2025-09-04T04:34:11Z,final_summary_en,gpt-4.1-mini,5562,1257,6819
2025-09-04T04:34:27Z,final_summary_en,gpt-4.1-mini,6733,1249,7982
2025-09-04T04:34:45Z,final_summary_en,gpt-4.1-mini,1215,1123,2338
2025-09-04T04:35:03Z,final_summary_en,gpt-4.1-mini,5638,1141,6779
2025-09-04T04:35:21Z,final_summary_en,gpt-4.1-mini,1353,1208,2561
2025-09-04T04:35:46Z,final_summary_en,gpt-4.1-mini,1748,1489,3237
2025-09-04T04:36:04Z,final_summary_en,gpt-4.1-mini,1658,1075,2733
2025-09-04T04:36:21Z,final_summary_en,gpt-4.1-mini,1106,1192,2298
2025-09-04T04:36:52Z,final_summary_en,gpt-4.1-mini,1388,1366,2754
2025-09-04T04:37:13Z,final_summary_en,gpt-4.1-mini,2851,1351,4202
2025-09-04T04:37:33Z,final_summary_en,gpt-4.1-mini,1253,1413,2666
2025-09-04T04:38:39Z,category_summary,gpt-4.1-mini,120,45,165
2025-09-04T04:38:40Z,category_summary,gpt-4.1-mini,121,28,149
2025-09-04T04:38:42Z,category_summary,gpt-4.1-mini,128,34,162
2025-09-04T04:38:44Z,category_summary,gpt-4.1-mini,139,39,178
2025-09-04T04:38:46Z,category_summary,gpt-4.1-mini,98,25,123
2025-09-04T04:38:47Z,category_summary,gpt-4.1-mini,139,28,167
2025-09-04T04:38:48Z,RUN_TOTAL,,247736,37328,285064
2025-09-05T04:25:28Z,pre_sentiment,gpt-4.1-mini,285,1,286
2025-09-05T04:25:32Z,pre_sentiment,gpt-4.1-mini,291,1,292
2025-09-05T04:25:32Z,pre_sentiment,gpt-4.1-mini,288,1,289
2025-09-05T04:25:33Z,pre_sentiment,gpt-4.1-mini,283,1,284
2025-09-05T04:25:34Z,pre_sentiment,gpt-4.1-mini,282,1,283
2025-09-05T04:25:34Z,pre_sentiment,gpt-4.1-mini,284,1,285
2025-09-05T04:25:37Z,sentiment,gpt-4.1-mini,2093,170,2263
2025-09-05T04:25:38Z,pre_sentiment,gpt-4.1-mini,286,1,287
2025-09-05T04:25:39Z,pre_sentiment,gpt-4.1-mini,290,1,291
2025-09-05T04:25:39Z,pre_sentiment,gpt-4.1-mini,288,1,289
2025-09-05T04:25:40Z,pre_sentiment,gpt-4.1-mini,284,1,285
2025-09-05T04:25:40Z,pre_sentiment,gpt-4.1-mini,275,1,276
2025-09-05T04:25:40Z,pre_sentiment,gpt-4.1-mini,280,1,281
2025-09-05T04:25:41Z,pre_sentiment,gpt-4.1-mini,297,1,298
2025-09-05T04:25:43Z,sentiment,gpt-4.1-mini,2353,173,2526
2025-09-05T04:25:43Z,pre_sentiment,gpt-4.1-mini,280,1,281
2025-09-05T04:25:43Z,pre_sentiment,gpt-4.1-mini,284,1,285
2025-09-05T04:25:53Z,pre_sentiment,gpt-4.1-mini,285,1,286
2025-09-05T04:25:53Z,pre_sentiment,gpt-4.1-mini,282,1,283
2025-09-05T04:25:54Z,pre_sentiment,gpt-4.1-mini,279,1,280
2025-09-05T04:25:54Z,pre_sentiment,gpt-4.1-mini,277,1,278
2025-09-05T04:25:58Z,pre_sentiment,gpt-4.1-mini,282,1,283
2025-09-05T04:26:01Z,sentiment,gpt-4.1-mini,1843,217,2060
2025-09-05T04:26:02Z,pre_sentiment,gpt-4.1-mini,279,1,280
2025-09-05T04:26:14Z,pre_sentiment,gpt-4.1-mini,282,1,283
2025-09-05T04:26:14Z,pre_sentiment,gpt-4.1-mini,279,1,280
2025-09-05T04:26:17Z,sentiment,gpt-4.1-mini,1650,208,1858
2025-09-05T04:26:18Z,pre_sentiment,gpt-4.1-mini,280,1,281
2025-09-05T04:26:20Z,sentiment,gpt-4.1-mini,1905,182,2087
2025-09-05T04:26:21Z,pre_sentiment,gpt-4.1-mini,280,1,281
2025-09-05T04:26:24Z,sentiment,gpt-4.1-mini,1455,212,1667
2025-09-05T04:26:25Z,pre_sentiment,gpt-4.1-mini,283,1,284
2025-09-05T04:26:28Z,sentiment,gpt-4.1-mini,1468,189,1657
2025-09-05T04:26:29Z,pre_sentiment,gpt-4.1-mini,277,1,278
2025-09-05T04:26:35Z,sentiment,gpt-4.1-mini,1455,204,1659
2025-09-05T04:26:36Z,pre_sentiment,gpt-4.1-mini,291,1,292
2025-09-05T04:26:40Z,sentiment,gpt-4.1-mini,1475,201,1676
2025-09-05T04:26:41Z,pre_sentiment,gpt-4.1-mini,279,1,280
2025-09-05T04:26:44Z,sentiment,gpt-4.1-mini,1475,204,1679
2025-09-05T04:26:45Z,pre_sentiment,gpt-4.1-mini,283,1,284
2025-09-05T04:26:48Z,sentiment,gpt-4.1-mini,2007,205,2212
2025-09-05T04:26:48Z,pre_sentiment,gpt-4.1-mini,290,1,291
2025-09-05T04:26:51Z,sentiment,gpt-4.1-mini,1625,185,1810
2025-09-05T04:27:05Z,pre_sentiment,gpt-4.1-mini,297,1,298
2025-09-05T04:27:06Z,sentiment,gpt-4.1-mini,932,95,1027
2025-09-05T04:27:07Z,pre_sentiment,gpt-4.1-mini,294,1,295
2025-09-05T04:27:09Z,sentiment,gpt-4.1-mini,915,96,1011
2025-09-05T04:27:09Z,pre_sentiment,gpt-4.1-mini,295,1,296
2025-09-05T04:27:09Z,pre_sentiment,gpt-4.1-mini,302,1,303
2025-09-05T04:27:09Z,pre_sentiment,gpt-4.1-mini,298,1,299
2025-09-05T04:27:13Z,sentiment,gpt-4.1-mini,1466,216,1682
2025-09-05T04:27:13Z,pre_sentiment,gpt-4.1-mini,298,1,299
2025-09-05T04:27:16Z,sentiment,gpt-4.1-mini,1365,174,1539
2025-09-05T04:27:16Z,pre_sentiment,gpt-4.1-mini,300,1,301
2025-09-05T04:27:17Z,pre_sentiment,gpt-4.1-mini,303,1,304
2025-09-05T04:27:21Z,sentiment,gpt-4.1-mini,1146,183,1329
2025-09-05T04:27:22Z,pre_sentiment,gpt-4.1-mini,300,1,301
2025-09-05T04:27:26Z,sentiment,gpt-4.1-mini,965,160,1125
2025-09-05T04:27:26Z,pre_sentiment,gpt-4.1-mini,291,1,292
2025-09-05T04:27:28Z,sentiment,gpt-4.1-mini,908,99,1007
2025-09-05T04:27:28Z,pre_sentiment,gpt-4.1-mini,298,1,299
2025-09-05T04:27:31Z,sentiment,gpt-4.1-mini,5570,187,5757
2025-09-05T04:27:49Z,pre_sentiment,gpt-4.1-mini,292,1,293
2025-09-05T04:27:51Z,sentiment,gpt-4.1-mini,1916,170,2086
2025-09-05T04:27:52Z,pre_sentiment,gpt-4.1-mini,275,1,276
2025-09-05T04:27:55Z,sentiment,gpt-4.1-mini,1084,188,1272
2025-09-05T04:27:55Z,pre_sentiment,gpt-4.1-mini,286,1,287
2025-09-05T04:27:59Z,sentiment,gpt-4.1-mini,2237,225,2462
2025-09-05T04:27:59Z,pre_sentiment,gpt-4.1-mini,289,1,290
2025-09-05T04:28:02Z,sentiment,gpt-4.1-mini,2120,252,2372
2025-09-05T04:28:03Z,pre_sentiment,gpt-4.1-mini,292,1,293
2025-09-05T04:28:04Z,sentiment,gpt-4.1-mini,1042,123,1165
2025-09-05T04:28:05Z,pre_sentiment,gpt-4.1-mini,284,1,285
2025-09-05T04:28:07Z,sentiment,gpt-4.1-mini,1521,163,1684
2025-09-05T04:28:07Z,pre_sentiment,gpt-4.1-mini,283,1,284
2025-09-05T04:28:09Z,sentiment,gpt-4.1-mini,2346,156,2502
2025-09-05T04:28:10Z,pre_sentiment,gpt-4.1-mini,285,1,286
2025-09-05T04:28:12Z,sentiment,gpt-4.1-mini,1783,181,1964
2025-09-05T04:28:19Z,pre_sentiment,gpt-4.1-mini,286,1,287
2025-09-05T04:28:21Z,sentiment,gpt-4.1-mini,2150,194,2344
2025-09-05T04:28:44Z,pre_sentiment,gpt-4.1-mini,270,1,271
2025-09-05T04:28:44Z,pre_sentiment,gpt-4.1-mini,295,1,296
2025-09-05T04:28:48Z,pre_sentiment,gpt-4.1-mini,275,1,276
2025-09-05T04:28:52Z,sentiment,gpt-4.1-mini,1813,206,2019
2025-09-05T04:28:53Z,pre_sentiment,gpt-4.1-mini,275,1,276
2025-09-05T04:28:56Z,sentiment,gpt-4.1-mini,1773,179,1952
2025-09-05T04:28:56Z,pre_sentiment,gpt-4.1-mini,282,1,283
2025-09-05T04:28:56Z,pre_sentiment,gpt-4.1-mini,276,1,277
2025-09-05T04:28:57Z,pre_sentiment,gpt-4.1-mini,278,1,279
2025-09-05T04:28:57Z,pre_sentiment,gpt-4.1-mini,278,1,279
2025-09-05T04:29:03Z,pre_sentiment,gpt-4.1-mini,280,1,281
2025-09-05T04:29:06Z,sentiment,gpt-4.1-mini,1473,205,1678
2025-09-05T04:29:07Z,pre_sentiment,gpt-4.1-mini,281,1,282
2025-09-05T04:29:07Z,pre_sentiment,gpt-4.1-mini,292,1,293
2025-09-05T04:29:10Z,sentiment,gpt-4.1-mini,1887,197,2084
2025-09-05T04:29:11Z,pre_sentiment,gpt-4.1-mini,278,1,279
2025-09-05T04:29:14Z,sentiment,gpt-4.1-mini,1824,202,2026
2025-09-05T04:29:14Z,pre_sentiment,gpt-4.1-mini,283,1,284
2025-09-05T04:29:18Z,sentiment,gpt-4.1-mini,1454,200,1654
2025-09-05T04:29:49Z,pre_sentiment,gpt-4.1-mini,288,1,289
2025-09-05T04:29:49Z,pre_sentiment,gpt-4.1-mini,286,1,287
2025-09-05T04:29:51Z,sentiment,gpt-4.1-mini,1061,121,1182
2025-09-05T04:30:08Z,pre_sentiment,gpt-4.1-mini,286,1,287
2025-09-05T04:30:10Z,sentiment,gpt-4.1-mini,1061,128,1189
2025-09-05T04:30:10Z,pre_sentiment,gpt-4.1-mini,283,1,284
2025-09-05T04:30:15Z,pre_sentiment,gpt-4.1-mini,282,1,283
2025-09-05T04:30:22Z,sentiment,gpt-4.1-mini,1206,128,1334
2025-09-05T04:30:22Z,pre_sentiment,gpt-4.1-mini,294,1,295
2025-09-05T04:30:33Z,sentiment,gpt-4.1-mini,1588,228,1816
2025-09-05T04:30:34Z,pre_sentiment,gpt-4.1-mini,291,1,292
2025-09-05T04:30:37Z,sentiment,gpt-4.1-mini,1754,149,1903
2025-09-05T04:30:38Z,pre_sentiment,gpt-4.1-mini,296,1,297
2025-09-05T04:30:40Z,sentiment,gpt-4.1-mini,1637,152,1789
2025-09-05T04:30:47Z,pre_sentiment,gpt-4.1-mini,287,1,288
2025-09-05T04:30:50Z,sentiment,gpt-4.1-mini,1317,131,1448
2025-09-05T04:31:00Z,pre_sentiment,gpt-4.1-mini,287,1,288
2025-09-05T04:31:00Z,pre_sentiment,gpt-4.1-mini,306,1,307
2025-09-05T04:31:01Z,pre_sentiment,gpt-4.1-mini,288,1,289
2025-09-05T04:31:12Z,pre_sentiment,gpt-4.1-mini,292,1,293
2025-09-05T04:31:17Z,sentiment,gpt-4.1-mini,2958,247,3205
2025-09-05T04:31:17Z,pre_sentiment,gpt-4.1-mini,287,1,288
2025-09-05T04:31:29Z,pre_sentiment,gpt-4.1-mini,302,1,303
2025-09-05T04:31:29Z,pre_sentiment,gpt-4.1-mini,315,1,316
2025-09-05T04:31:29Z,pre_sentiment,gpt-4.1-mini,293,1,294
2025-09-05T04:31:30Z,pre_sentiment,gpt-4.1-mini,289,1,290
2025-09-05T04:31:33Z,sentiment,gpt-4.1-mini,1457,167,1624
2025-09-05T04:31:33Z,pre_sentiment,gpt-4.1-mini,284,1,285
2025-09-05T04:31:36Z,sentiment,gpt-4.1-mini,1158,183,1341
2025-09-05T04:31:36Z,pre_sentiment,gpt-4.1-mini,297,1,298
2025-09-05T04:31:37Z,pre_sentiment,gpt-4.1-mini,283,1,284
2025-09-05T04:31:37Z,pre_sentiment,gpt-4.1-mini,278,1,279
2025-09-05T04:31:40Z,sentiment,gpt-4.1-mini,1348,163,1511
2025-09-05T04:31:40Z,pre_sentiment,gpt-4.1-mini,288,1,289
2025-09-05T04:31:44Z,sentiment,gpt-4.1-mini,1270,248,1518
2025-09-05T04:31:52Z,article_selection,gpt-4.1-mini,1262,12,1274
2025-09-05T04:31:52Z,article_selection,gpt-4.1-mini,1774,12,1786
2025-09-05T04:31:53Z,article_selection,gpt-4.1-mini,1025,9,1034
2025-09-05T04:31:53Z,article_selection,gpt-4.1-mini,716,9,725
2025-09-05T04:31:54Z,article_selection,gpt-4.1-mini,772,16,788
2025-09-05T04:32:14Z,final_summary_en,gpt-4.1-mini,1210,930,2140
2025-09-05T04:32:31Z,final_summary_en,gpt-4.1-mini,1411,1061,2472
2025-09-05T04:32:55Z,final_summary_en,gpt-4.1-mini,1212,1045,2257
2025-09-05T04:33:12Z,final_summary_en,gpt-4.1-mini,1567,1125,2692
2025-09-05T04:33:36Z,final_summary_en,gpt-4.1-mini,1563,1306,2869
2025-09-05T04:33:56Z,final_summary_en,gpt-4.1-mini,2745,1193,3938
2025-09-05T04:34:14Z,final_summary_en,gpt-4.1-mini,1517,1125,2642
2025-09-05T04:34:32Z,final_summary_en,gpt-4.1-mini,908,1219,2127
2025-09-05T04:34:51Z,final_summary_en,gpt-4.1-mini,1602,1288,2890
2025-09-05T04:35:12Z,final_summary_en,gpt-4.1-mini,1213,1055,2268
2025-09-05T04:35:30Z,final_summary_en,gpt-4.1-mini,1229,1015,2244
2025-09-05T04:35:44Z,final_summary_en,gpt-4.1-mini,694,948,1642
2025-09-05T04:36:02Z,final_summary_en,gpt-4.1-mini,1645,1169,2814
2025-09-05T04:36:19Z,final_summary_en,gpt-4.1-mini,1232,1027,2259
2025-09-05T04:36:40Z,final_summary_en,gpt-4.1-mini,1363,1135,2498
2025-09-05T04:36:56Z,final_summary_en,gpt-4.1-mini,1905,999,2904
2025-09-05T04:37:12Z,final_summary_en,gpt-4.1-mini,1372,1112,2484
2025-09-05T04:37:29Z,final_summary_en,gpt-4.1-mini,1983,1288,3271
2025-09-05T04:37:49Z,final_summary_en,gpt-4.1-mini,1913,1527,3440
2025-09-05T04:38:09Z,final_summary_en,gpt-4.1-mini,1637,1113,2750
2025-09-05T04:38:29Z,final_summary_en,gpt-4.1-mini,1216,1151,2367
2025-09-05T04:39:39Z,category_summary,gpt-4.1-mini,124,38,162
2025-09-05T04:39:41Z,category_summary,gpt-4.1-mini,125,27,152
2025-09-05T04:39:43Z,category_summary,gpt-4.1-mini,128,38,166
2025-09-05T04:39:45Z,category_summary,gpt-4.1-mini,133,30,163
2025-09-05T04:39:47Z,category_summary,gpt-4.1-mini,144,53,197
2025-09-05T04:39:48Z,RUN_TOTAL,,140607,32608,173215
2025-09-06T04:24:21Z,pre_sentiment,gpt-4.1-mini,282,1,283
2025-09-06T04:24:22Z,pre_sentiment,gpt-4.1-mini,289,1,290
2025-09-06T04:24:23Z,pre_sentiment,gpt-4.1-mini,279,1,280
2025-09-06T04:24:24Z,pre_sentiment,gpt-4.1-mini,284,1,285
2025-09-06T04:24:25Z,pre_sentiment,gpt-4.1-mini,279,1,280
2025-09-06T04:24:26Z,pre_sentiment,gpt-4.1-mini,288,1,289
2025-09-06T04:24:27Z,sentiment,gpt-4.1-mini,1169,105,1274
2025-09-06T04:24:28Z,pre_sentiment,gpt-4.1-mini,284,1,285
2025-09-06T04:24:29Z,pre_sentiment,gpt-4.1-mini,287,1,288
2025-09-06T04:24:29Z,pre_sentiment,gpt-4.1-mini,281,1,282
2025-09-06T04:24:29Z,pre_sentiment,gpt-4.1-mini,281,1,282
2025-09-06T04:24:30Z,pre_sentiment,gpt-4.1-mini,284,1,285
2025-09-06T04:24:30Z,pre_sentiment,gpt-4.1-mini,282,1,283
2025-09-06T04:24:31Z,pre_sentiment,gpt-4.1-mini,291,1,292
2025-09-06T04:24:31Z,pre_sentiment,gpt-4.1-mini,282,1,283
2025-09-06T04:24:43Z,pre_sentiment,gpt-4.1-mini,278,1,279
2025-09-06T04:24:43Z,pre_sentiment,gpt-4.1-mini,285,1,286
2025-09-06T04:24:52Z,pre_sentiment,gpt-4.1-mini,281,1,282
2025-09-06T04:24:56Z,sentiment,gpt-4.1-mini,1702,162,1864
2025-09-06T04:25:02Z,pre_sentiment,gpt-4.1-mini,282,1,283
2025-09-06T04:25:04Z,sentiment,gpt-4.1-mini,1596,156,1752
2025-09-06T04:25:04Z,pre_sentiment,gpt-4.1-mini,282,1,283
2025-09-06T04:25:05Z,pre_sentiment,gpt-4.1-mini,275,1,276
2025-09-06T04:25:09Z,sentiment,gpt-4.1-mini,1316,212,1528
2025-09-06T04:25:10Z,pre_sentiment,gpt-4.1-mini,280,1,281
2025-09-06T04:25:12Z,sentiment,gpt-4.1-mini,1453,178,1631
2025-09-06T04:25:13Z,pre_sentiment,gpt-4.1-mini,280,1,281
2025-09-06T04:25:13Z,pre_sentiment,gpt-4.1-mini,289,1,290
2025-09-06T04:25:16Z,sentiment,gpt-4.1-mini,1964,181,2145
2025-09-06T04:25:16Z,pre_sentiment,gpt-4.1-mini,280,1,281
2025-09-06T04:25:20Z,sentiment,gpt-4.1-mini,1574,211,1785
2025-09-06T04:25:38Z,pre_sentiment,gpt-4.1-mini,299,1,300
2025-09-06T04:25:40Z,sentiment,gpt-4.1-mini,1015,109,1124
2025-09-06T04:25:40Z,pre_sentiment,gpt-4.1-mini,310,1,311
2025-09-06T04:25:42Z,sentiment,gpt-4.1-mini,1058,100,1158
2025-09-06T04:25:43Z,pre_sentiment,gpt-4.1-mini,297,1,298
2025-09-06T04:25:46Z,sentiment,gpt-4.1-mini,923,178,1101
2025-09-06T04:25:46Z,pre_sentiment,gpt-4.1-mini,308,1,309
2025-09-06T04:25:48Z,sentiment,gpt-4.1-mini,932,92,1024
2025-09-06T04:25:48Z,pre_sentiment,gpt-4.1-mini,307,1,308
2025-09-06T04:25:51Z,sentiment,gpt-4.1-mini,1693,229,1922
2025-09-06T04:25:52Z,pre_sentiment,gpt-4.1-mini,302,1,303
2025-09-06T04:25:55Z,sentiment,gpt-4.1-mini,1878,216,2094
2025-09-06T04:25:55Z,pre_sentiment,gpt-4.1-mini,299,1,300
2025-09-06T04:25:58Z,sentiment,gpt-4.1-mini,1784,207,1991
2025-09-06T04:25:59Z,pre_sentiment,gpt-4.1-mini,285,1,286
2025-09-06T04:26:01Z,sentiment,gpt-4.1-mini,1678,185,1863
2025-09-06T04:26:02Z,pre_sentiment,gpt-4.1-mini,297,1,298
2025-09-06T04:26:03Z,sentiment,gpt-4.1-mini,932,98,1030
2025-09-06T04:26:04Z,pre_sentiment,gpt-4.1-mini,294,1,295
2025-09-06T04:26:05Z,sentiment,gpt-4.1-mini,915,120,1035
2025-09-06T04:26:06Z,pre_sentiment,gpt-4.1-mini,293,1,294
2025-09-06T04:26:06Z,pre_sentiment,gpt-4.1-mini,301,1,302
2025-09-06T04:26:06Z,pre_sentiment,gpt-4.1-mini,298,1,299
2025-09-06T04:26:09Z,sentiment,gpt-4.1-mini,1365,179,1544
2025-09-06T04:26:25Z,pre_sentiment,gpt-4.1-mini,281,1,282
2025-09-06T04:26:28Z,sentiment,gpt-4.1-mini,1442,153,1595
2025-09-06T04:26:28Z,pre_sentiment,gpt-4.1-mini,283,1,284
2025-09-06T04:26:33Z,sentiment,gpt-4.1-mini,2257,218,2475
2025-09-06T04:26:34Z,pre_sentiment,gpt-4.1-mini,274,1,275
2025-09-06T04:26:36Z,sentiment,gpt-4.1-mini,1014,123,1137
2025-09-06T04:26:36Z,pre_sentiment,gpt-4.1-mini,285,1,286
2025-09-06T04:26:39Z,sentiment,gpt-4.1-mini,1390,120,1510
2025-09-06T04:26:39Z,pre_sentiment,gpt-4.1-mini,280,1,281
2025-09-06T04:26:42Z,sentiment,gpt-4.1-mini,1257,142,1399
2025-09-06T04:26:49Z,pre_sentiment,gpt-4.1-mini,281,1,282
2025-09-06T04:26:51Z,sentiment,gpt-4.1-mini,918,110,1028
2025-09-06T04:26:55Z,pre_sentiment,gpt-4.1-mini,296,1,297
2025-09-06T04:26:59Z,sentiment,gpt-4.1-mini,2742,210,2952
2025-09-06T04:26:59Z,pre_sentiment,gpt-4.1-mini,265,1,266
2025-09-06T04:27:00Z,pre_sentiment,gpt-4.1-mini,268,1,269
2025-09-06T04:27:28Z,pre_sentiment,gpt-4.1-mini,287,1,288
2025-09-06T04:27:31Z,sentiment,gpt-4.1-mini,1656,207,1863
2025-09-06T04:27:31Z,pre_sentiment,gpt-4.1-mini,289,1,290
2025-09-06T04:27:34Z,sentiment,gpt-4.1-mini,1497,153,1650
2025-09-06T04:27:34Z,pre_sentiment,gpt-4.1-mini,276,1,277
2025-09-06T04:27:37Z,sentiment,gpt-4.1-mini,1440,190,1630
2025-09-06T04:27:37Z,pre_sentiment,gpt-4.1-mini,281,1,282
2025-09-06T04:27:41Z,sentiment,gpt-4.1-mini,1330,180,1510
2025-09-06T04:27:41Z,pre_sentiment,gpt-4.1-mini,286,1,287
2025-09-06T04:27:44Z,sentiment,gpt-4.1-mini,1687,150,1837
2025-09-06T04:28:02Z,pre_sentiment,gpt-4.1-mini,285,1,286
2025-09-06T04:28:05Z,sentiment,gpt-4.1-mini,1148,112,1260
2025-09-06T04:28:26Z,pre_sentiment,gpt-4.1-mini,297,1,298
2025-09-06T04:28:29Z,sentiment,gpt-4.1-mini,1806,190,1996
2025-09-06T04:28:29Z,pre_sentiment,gpt-4.1-mini,282,1,283
2025-09-06T04:28:31Z,sentiment,gpt-4.1-mini,1206,132,1338
2025-09-06T04:28:31Z,pre_sentiment,gpt-4.1-mini,291,1,292
2025-09-06T04:28:34Z,sentiment,gpt-4.1-mini,1754,149,1903
2025-09-06T04:29:00Z,pre_sentiment,gpt-4.1-mini,288,1,289
2025-09-06T04:29:01Z,pre_sentiment,gpt-4.1-mini,296,1,297
2025-09-06T04:29:01Z,pre_sentiment,gpt-4.1-mini,292,1,293
2025-09-06T04:29:04Z,sentiment,gpt-4.1-mini,1380,217,1597
2025-09-06T04:29:04Z,pre_sentiment,gpt-4.1-mini,295,1,296
2025-09-06T04:29:05Z,pre_sentiment,gpt-4.1-mini,286,1,287
2025-09-06T04:29:05Z,pre_sentiment,gpt-4.1-mini,289,1,290
2025-09-06T04:29:09Z,sentiment,gpt-4.1-mini,1504,197,1701
2025-09-06T04:29:09Z,pre_sentiment,gpt-4.1-mini,286,1,287
2025-09-06T04:29:25Z,pre_sentiment,gpt-4.1-mini,285,1,286
2025-09-06T04:29:26Z,pre_sentiment,gpt-4.1-mini,285,1,286
2025-09-06T04:29:26Z,pre_sentiment,gpt-4.1-mini,295,1,296
2025-09-06T04:29:30Z,sentiment,gpt-4.1-mini,2642,207,2849
2025-09-06T04:29:46Z,pre_sentiment,gpt-4.1-mini,291,1,292
2025-09-06T04:29:46Z,pre_sentiment,gpt-4.1-mini,281,1,282
2025-09-06T04:29:47Z,pre_sentiment,gpt-4.1-mini,279,1,280
2025-09-06T04:29:49Z,sentiment,gpt-4.1-mini,1166,158,1324
2025-09-06T04:29:50Z,pre_sentiment,gpt-4.1-mini,276,1,277
2025-09-06T04:29:52Z,sentiment,gpt-4.1-mini,1172,156,1328
2025-09-06T04:29:53Z,pre_sentiment,gpt-4.1-mini,279,1,280
2025-09-06T04:29:53Z,pre_sentiment,gpt-4.1-mini,291,1,292
2025-09-06T04:29:54Z,pre_sentiment,gpt-4.1-mini,287,1,288
2025-09-06T04:29:56Z,sentiment,gpt-4.1-mini,1171,185,1356
2025-09-06T04:29:57Z,pre_sentiment,gpt-4.1-mini,279,1,280
2025-09-06T04:29:58Z,pre_sentiment,gpt-4.1-mini,285,1,286
2025-09-06T04:29:58Z,pre_sentiment,gpt-4.1-mini,276,1,277
2025-09-06T04:30:02Z,sentiment,gpt-4.1-mini,973,182,1155
2025-09-06T04:30:02Z,pre_sentiment,gpt-4.1-mini,280,1,281
2025-09-06T04:30:03Z,pre_sentiment,gpt-4.1-mini,282,1,283
2025-09-06T04:30:04Z,pre_sentiment,gpt-4.1-mini,288,1,289
2025-09-06T04:30:07Z,sentiment,gpt-4.1-mini,3010,176,3186
2025-09-06T04:30:07Z,pre_sentiment,gpt-4.1-mini,297,1,298
2025-09-06T04:30:24Z,article_selection,gpt-4.1-mini,1037,9,1046
2025-09-06T04:30:25Z,article_selection,gpt-4.1-mini,780,12,792
2025-09-06T04:30:25Z,article_selection,gpt-4.1-mini,720,12,732
2025-09-06T04:30:26Z,article_selection,gpt-4.1-mini,448,10,458
2025-09-06T04:30:26Z,article_selection,gpt-4.1-mini,698,12,710
2025-09-06T04:30:27Z,article_selection,gpt-4.1-mini,481,5,486
2025-09-06T04:30:41Z,final_summary_en,gpt-4.1-mini,1055,950,2005
2025-09-06T04:31:02Z,final_summary_en,gpt-4.1-mini,1704,1295,2999
2025-09-06T04:31:16Z,final_summary_en,gpt-4.1-mini,1085,901,1986
2025-09-06T04:31:34Z,final_summary_en,gpt-4.1-mini,1155,1127,2282
2025-09-06T04:31:50Z,final_summary_en,gpt-4.1-mini,1468,1216,2684
2025-09-06T04:32:02Z,final_summary_en,gpt-4.1-mini,1198,984,2182
2025-09-06T04:32:15Z,final_summary_en,gpt-4.1-mini,677,1035,1712
2025-09-06T04:32:32Z,final_summary_en,gpt-4.1-mini,1118,1127,2245
2025-09-06T04:32:43Z,final_summary_en,gpt-4.1-mini,1191,827,2018
2025-09-06T04:32:58Z,final_summary_en,gpt-4.1-mini,1335,1144,2479
2025-09-06T04:33:18Z,final_summary_en,gpt-4.1-mini,1549,1119,2668
2025-09-06T04:33:31Z,final_summary_en,gpt-4.1-mini,1327,1007,2334
2025-09-06T04:33:47Z,final_summary_en,gpt-4.1-mini,2023,1230,3253
2025-09-06T04:34:01Z,final_summary_en,gpt-4.1-mini,1435,1059,2494
2025-09-06T04:34:18Z,final_summary_en,gpt-4.1-mini,2386,1181,3567
2025-09-06T04:34:38Z,final_summary_en,gpt-4.1-mini,1248,1279,2527
2025-09-06T04:34:54Z,final_summary_en,gpt-4.1-mini,897,1050,1947
2025-09-06T04:35:07Z,final_summary_en,gpt-4.1-mini,725,974,1699
2025-09-06T04:35:29Z,final_summary_en,gpt-4.1-mini,1561,1073,2634
2025-09-06T04:35:43Z,final_summary_en,gpt-4.1-mini,1434,874,2308
2025-09-06T04:36:45Z,category_summary,gpt-4.1-mini,135,29,164
2025-09-06T04:36:47Z,category_summary,gpt-4.1-mini,130,32,162
2025-09-06T04:36:50Z,category_summary,gpt-4.1-mini,126,29,155
2025-09-06T04:36:52Z,category_summary,gpt-4.1-mini,138,37,175
2025-09-06T04:36:54Z,category_summary,gpt-4.1-mini,102,42,144
2025-09-06T04:36:56Z,category_summary,gpt-4.1-mini,103,18,121
2025-09-06T04:36:58Z,RUN_TOTAL,,116608,28713,145321
2025-09-07T04:23:46Z,pre_sentiment,gpt-4.1-mini,281,1,282
2025-09-07T04:23:47Z,pre_sentiment,gpt-4.1-mini,284,1,285
2025-09-07T04:23:48Z,pre_sentiment,gpt-4.1-mini,290,1,291
2025-09-07T04:23:48Z,pre_sentiment,gpt-4.1-mini,291,1,292
2025-09-07T04:23:50Z,sentiment,gpt-4.1-mini,1422,167,1589
2025-09-07T04:23:51Z,pre_sentiment,gpt-4.1-mini,281,1,282
2025-09-07T04:23:55Z,sentiment,gpt-4.1-mini,1261,204,1465
2025-09-07T04:23:55Z,pre_sentiment,gpt-4.1-mini,285,1,286
2025-09-07T04:23:55Z,pre_sentiment,gpt-4.1-mini,284,1,285
2025-09-07T04:23:56Z,pre_sentiment,gpt-4.1-mini,289,1,290
2025-09-07T04:23:57Z,pre_sentiment,gpt-4.1-mini,293,1,294
2025-09-07T04:23:57Z,pre_sentiment,gpt-4.1-mini,284,1,285
2025-09-07T04:23:57Z,pre_sentiment,gpt-4.1-mini,292,1,293
2025-09-07T04:23:58Z,pre_sentiment,gpt-4.1-mini,285,1,286
2025-09-07T04:23:58Z,pre_sentiment,gpt-4.1-mini,289,1,290
2025-09-07T04:24:00Z,sentiment,gpt-4.1-mini,2133,202,2335
2025-09-07T04:24:00Z,pre_sentiment,gpt-4.1-mini,288,1,289
2025-09-07T04:24:02Z,pre_sentiment,gpt-4.1-mini,283,1,284
2025-09-07T04:24:19Z,pre_sentiment,gpt-4.1-mini,284,1,285
2025-09-07T04:24:20Z,pre_sentiment,gpt-4.1-mini,282,1,283
2025-09-07T04:24:22Z,sentiment,gpt-4.1-mini,2251,179,2430
2025-09-07T04:24:22Z,pre_sentiment,gpt-4.1-mini,286,1,287
2025-09-07T04:24:25Z,sentiment,gpt-4.1-mini,1823,244,2067
2025-09-07T04:24:25Z,pre_sentiment,gpt-4.1-mini,285,1,286
2025-09-07T04:24:28Z,sentiment,gpt-4.1-mini,1532,184,1716
2025-09-07T04:24:28Z,pre_sentiment,gpt-4.1-mini,288,1,289
2025-09-07T04:24:29Z,pre_sentiment,gpt-4.1-mini,283,1,284
2025-09-07T04:24:30Z,pre_sentiment,gpt-4.1-mini,288,1,289
2025-09-07T04:24:31Z,sentiment,gpt-4.1-mini,1957,161,2118
2025-09-07T04:24:32Z,pre_sentiment,gpt-4.1-mini,279,1,280
2025-09-07T04:24:34Z,sentiment,gpt-4.1-mini,2320,200,2520
2025-09-07T04:24:48Z,pre_sentiment,gpt-4.1-mini,299,1,300
2025-09-07T04:24:50Z,sentiment,gpt-4.1-mini,1015,87,1102
2025-09-07T04:24:50Z,pre_sentiment,gpt-4.1-mini,310,1,311
2025-09-07T04:24:52Z,sentiment,gpt-4.1-mini,1058,105,1163
2025-09-07T04:24:52Z,pre_sentiment,gpt-4.1-mini,308,1,309
2025-09-07T04:24:53Z,sentiment,gpt-4.1-mini,932,94,1026
2025-09-07T04:24:54Z,pre_sentiment,gpt-4.1-mini,302,1,303
2025-09-07T04:24:56Z,sentiment,gpt-4.1-mini,1878,226,2104
2025-09-07T04:24:57Z,pre_sentiment,gpt-4.1-mini,297,1,298
2025-09-07T04:24:58Z,sentiment,gpt-4.1-mini,932,104,1036
2025-09-07T04:24:58Z,pre_sentiment,gpt-4.1-mini,294,1,295
2025-09-07T04:25:00Z,sentiment,gpt-4.1-mini,915,93,1008
2025-09-07T04:25:00Z,pre_sentiment,gpt-4.1-mini,293,1,294
2025-09-07T04:25:00Z,pre_sentiment,gpt-4.1-mini,301,1,302
2025-09-07T04:25:44Z,pre_sentiment,gpt-4.1-mini,266,1,267
2025-09-07T04:25:48Z,sentiment,gpt-4.1-mini,2385,220,2605
2025-09-07T04:26:14Z,pre_sentiment,gpt-4.1-mini,292,1,293
2025-09-07T04:26:15Z,sentiment,gpt-4.1-mini,1874,136,2010
2025-09-07T04:27:12Z,pre_sentiment,gpt-4.1-mini,295,1,296
2025-09-07T04:27:24Z,pre_sentiment,gpt-4.1-mini,285,1,286
2025-09-07T04:27:24Z,pre_sentiment,gpt-4.1-mini,292,1,293
2025-09-07T04:27:49Z,article_selection,gpt-4.1-mini,507,13,520
2025-09-07T04:27:49Z,article_selection,gpt-4.1-mini,367,5,372
2025-09-07T04:27:50Z,article_selection,gpt-4.1-mini,452,9,461
2025-09-07T04:28:04Z,final_summary_en,gpt-4.1-mini,2067,1136,3203
2025-09-07T04:28:21Z,final_summary_en,gpt-4.1-mini,1273,1161,2434
2025-09-07T04:28:37Z,final_summary_en,gpt-4.1-mini,2154,1228,3382
2025-09-07T04:28:51Z,final_summary_en,gpt-4.1-mini,1903,960,2863
2025-09-07T04:29:04Z,final_summary_en,gpt-4.1-mini,1030,1065,2095
2025-09-07T04:29:24Z,final_summary_en,gpt-4.1-mini,1607,1417,3024
2025-09-07T04:29:43Z,final_summary_en,gpt-4.1-mini,1657,1392,3049
2025-09-07T04:29:59Z,final_summary_en,gpt-4.1-mini,1995,1277,3272
2025-09-07T04:30:13Z,final_summary_en,gpt-4.1-mini,1687,1154,2841
2025-09-07T04:30:25Z,final_summary_en,gpt-4.1-mini,1164,961,2125
2025-09-07T04:30:53Z,category_summary,gpt-4.1-mini,105,33,138
2025-09-07T04:30:55Z,category_summary,gpt-4.1-mini,112,30,142
2025-09-07T04:30:56Z,category_summary,gpt-4.1-mini,104,22,126
2025-09-07T04:30:58Z,category_summary,gpt-4.1-mini,85,25,110
2025-09-07T04:30:59Z,category_summary,gpt-4.1-mini,90,26,116
2025-09-07T04:31:00Z,RUN_TOTAL,,54455,14556,69011
2025-09-08T04:26:37Z,pre_sentiment,gpt-4.1-mini,286,1,287
2025-09-08T04:26:37Z,pre_sentiment,gpt-4.1-mini,285,1,286
2025-09-08T04:26:41Z,sentiment,gpt-4.1-mini,1799,181,1980
2025-09-08T04:26:41Z,pre_sentiment,gpt-4.1-mini,287,1,288
2025-09-08T04:26:42Z,pre_sentiment,gpt-4.1-mini,282,1,283
2025-09-08T04:26:45Z,sentiment,gpt-4.1-mini,985,132,1117
2025-09-08T04:26:45Z,pre_sentiment,gpt-4.1-mini,282,1,283
2025-09-08T04:26:46Z,pre_sentiment,gpt-4.1-mini,284,1,285
2025-09-08T04:26:46Z,pre_sentiment,gpt-4.1-mini,279,1,280
2025-09-08T04:26:47Z,pre_sentiment,gpt-4.1-mini,272,1,273
2025-09-08T04:26:47Z,pre_sentiment,gpt-4.1-mini,283,1,284
2025-09-08T04:26:51Z,sentiment,gpt-4.1-mini,1324,232,1556
2025-09-08T04:26:51Z,pre_sentiment,gpt-4.1-mini,284,1,285
2025-09-08T04:26:52Z,pre_sentiment,gpt-4.1-mini,284,1,285
2025-09-08T04:26:52Z,pre_sentiment,gpt-4.1-mini,284,1,285
2025-09-08T04:26:54Z,sentiment,gpt-4.1-mini,899,119,1018
2025-09-08T04:26:54Z,pre_sentiment,gpt-4.1-mini,288,1,289
2025-09-08T04:26:57Z,sentiment,gpt-4.1-mini,1013,167,1180
2025-09-08T04:27:00Z,pre_sentiment,gpt-4.1-mini,282,1,283
2025-09-08T04:27:11Z,pre_sentiment,gpt-4.1-mini,281,1,282
2025-09-08T04:27:13Z,sentiment,gpt-4.1-mini,1710,149,1859
2025-09-08T04:27:20Z,pre_sentiment,gpt-4.1-mini,283,1,284
2025-09-08T04:27:23Z,sentiment,gpt-4.1-mini,2069,191,2260
2025-09-08T04:27:24Z,pre_sentiment,gpt-4.1-mini,284,1,285
2025-09-08T04:27:24Z,pre_sentiment,gpt-4.1-mini,283,1,284
2025-09-08T04:27:26Z,sentiment,gpt-4.1-mini,1457,183,1640
2025-09-08T04:27:27Z,pre_sentiment,gpt-4.1-mini,284,1,285
2025-09-08T04:27:29Z,sentiment,gpt-4.1-mini,1849,185,2034
2025-09-08T04:27:29Z,pre_sentiment,gpt-4.1-mini,284,1,285
2025-09-08T04:27:30Z,pre_sentiment,gpt-4.1-mini,280,1,281
2025-09-08T04:27:32Z,sentiment,gpt-4.1-mini,1968,169,2137
2025-09-08T04:27:32Z,pre_sentiment,gpt-4.1-mini,280,1,281
2025-09-08T04:27:35Z,sentiment,gpt-4.1-mini,1666,213,1879
2025-09-08T04:27:35Z,pre_sentiment,gpt-4.1-mini,282,1,283
2025-09-08T04:27:42Z,sentiment,gpt-4.1-mini,2269,222,2491
2025-09-08T04:27:43Z,pre_sentiment,gpt-4.1-mini,284,1,285
2025-09-08T04:27:43Z,pre_sentiment,gpt-4.1-mini,286,1,287
2025-09-08T04:27:46Z,sentiment,gpt-4.1-mini,1410,206,1616
2025-09-08T04:27:46Z,pre_sentiment,gpt-4.1-mini,291,1,292
2025-09-08T04:27:50Z,sentiment,gpt-4.1-mini,1808,217,2025
2025-09-08T04:27:50Z,pre_sentiment,gpt-4.1-mini,281,1,282
2025-09-08T04:28:04Z,pre_sentiment,gpt-4.1-mini,299,1,300
2025-09-08T04:28:05Z,sentiment,gpt-4.1-mini,1015,85,1100
2025-09-08T04:28:05Z,pre_sentiment,gpt-4.1-mini,310,1,311
2025-09-08T04:28:07Z,sentiment,gpt-4.1-mini,1058,99,1157
2025-09-08T04:28:08Z,pre_sentiment,gpt-4.1-mini,308,1,309
2025-09-08T04:28:09Z,sentiment,gpt-4.1-mini,932,91,1023
2025-09-08T04:28:09Z,pre_sentiment,gpt-4.1-mini,297,1,298
2025-09-08T04:28:11Z,sentiment,gpt-4.1-mini,932,113,1045
2025-09-08T04:28:12Z,pre_sentiment,gpt-4.1-mini,294,1,295
2025-09-08T04:28:13Z,sentiment,gpt-4.1-mini,915,90,1005
2025-09-08T04:28:13Z,pre_sentiment,gpt-4.1-mini,293,1,294
2025-09-08T04:28:14Z,pre_sentiment,gpt-4.1-mini,301,1,302
2025-09-08T04:28:33Z,pre_sentiment,gpt-4.1-mini,285,1,286
2025-09-08T04:28:36Z,sentiment,gpt-4.1-mini,1694,172,1866
2025-09-08T04:29:03Z,pre_sentiment,gpt-4.1-mini,275,1,276
2025-09-08T04:29:06Z,sentiment,gpt-4.1-mini,4839,163,5002
2025-09-08T04:29:10Z,pre_sentiment,gpt-4.1-mini,274,1,275
2025-09-08T04:29:27Z,pre_sentiment,gpt-4.1-mini,285,1,286
2025-09-08T04:29:30Z,sentiment,gpt-4.1-mini,1646,213,1859
2025-09-08T04:32:12Z,pre_sentiment,gpt-4.1-mini,286,1,287
2025-09-08T04:32:14Z,sentiment,gpt-4.1-mini,1732,148,1880
2025-09-08T04:32:15Z,pre_sentiment,gpt-4.1-mini,290,1,291
2025-09-08T04:32:20Z,sentiment,gpt-4.1-mini,1909,254,2163
2025-09-08T04:32:35Z,pre_sentiment,gpt-4.1-mini,282,1,283
2025-09-08T04:32:35Z,pre_sentiment,gpt-4.1-mini,285,1,286
2025-09-08T04:32:47Z,pre_sentiment,gpt-4.1-mini,277,1,278
2025-09-08T04:32:50Z,sentiment,gpt-4.1-mini,2469,159,2628
2025-09-08T04:32:51Z,pre_sentiment,gpt-4.1-mini,285,1,286
2025-09-08T04:33:09Z,article_selection,gpt-4.1-mini,718,16,734
2025-09-08T04:33:09Z,article_selection,gpt-4.1-mini,776,12,788
2025-09-08T04:33:10Z,article_selection,gpt-4.1-mini,571,6,577
2025-09-08T04:33:10Z,article_selection,gpt-4.1-mini,375,10,385
2025-09-08T04:33:29Z,final_summary_en,gpt-4.1-mini,2035,1183,3218
2025-09-08T04:33:46Z,final_summary_en,gpt-4.1-mini,1196,963,2159
2025-09-08T04:34:03Z,final_summary_en,gpt-4.1-mini,1607,1183,2790
2025-09-08T04:34:20Z,final_summary_en,gpt-4.1-mini,1154,1111,2265
2025-09-08T04:34:34Z,final_summary_en,gpt-4.1-mini,1408,1052,2460
2025-09-08T04:34:50Z,final_summary_en,gpt-4.1-mini,1694,1108,2802
2025-09-08T04:35:10Z,final_summary_en,gpt-4.1-mini,1422,1325,2747
2025-09-08T04:35:23Z,final_summary_en,gpt-4.1-mini,1431,1042,2473
2025-09-08T04:35:38Z,final_summary_en,gpt-4.1-mini,1705,1187,2892
2025-09-08T04:35:49Z,final_summary_en,gpt-4.1-mini,746,919,1665
2025-09-08T04:36:02Z,final_summary_en,gpt-4.1-mini,1562,1293,2855
2025-09-08T04:36:15Z,final_summary_en,gpt-4.1-mini,1102,1123,2225
2025-09-08T04:36:28Z,final_summary_en,gpt-4.1-mini,1554,1049,2603
2025-09-08T04:37:07Z,category_summary,gpt-4.1-mini,120,27,147
2025-09-08T04:37:08Z,category_summary,gpt-4.1-mini,130,42,172
2025-09-08T04:37:10Z,category_summary,gpt-4.1-mini,100,30,130
2025-09-08T04:37:11Z,category_summary,gpt-4.1-mini,87,27,114
2025-09-08T04:37:13Z,category_summary,gpt-4.1-mini,100,26,126
2025-09-08T04:37:14Z,RUN_TOTAL,,75531,18931,94462
2025-09-09T04:25:55Z,pre_sentiment,gpt-4.1-mini,284,1,285
2025-09-09T04:25:56Z,pre_sentiment,gpt-4.1-mini,290,1,291
2025-09-09T04:25:56Z,pre_sentiment,gpt-4.1-mini,280,1,281
2025-09-09T04:25:57Z,pre_sentiment,gpt-4.1-mini,282,1,283
2025-09-09T04:26:04Z,sentiment,gpt-4.1-mini,2123,176,2299
2025-09-09T04:26:05Z,pre_sentiment,gpt-4.1-mini,282,1,283
2025-09-09T04:26:05Z,pre_sentiment,gpt-4.1-mini,280,1,281
2025-09-09T04:26:06Z,pre_sentiment,gpt-4.1-mini,277,1,278
2025-09-09T04:26:07Z,pre_sentiment,gpt-4.1-mini,281,1,282
2025-09-09T04:26:07Z,pre_sentiment,gpt-4.1-mini,277,1,278
2025-09-09T04:26:08Z,pre_sentiment,gpt-4.1-mini,284,1,285
2025-09-09T04:26:08Z,pre_sentiment,gpt-4.1-mini,285,1,286
2025-09-09T04:26:08Z,pre_sentiment,gpt-4.1-mini,281,1,282
2025-09-09T04:26:09Z,pre_sentiment,gpt-4.1-mini,290,1,291
2025-09-09T04:26:09Z,pre_sentiment,gpt-4.1-mini,284,1,285
2025-09-09T04:26:10Z,pre_sentiment,gpt-4.1-mini,281,1,282
2025-09-09T04:26:17Z,pre_sentiment,gpt-4.1-mini,284,1,285
2025-09-09T04:26:17Z,pre_sentiment,gpt-4.1-mini,279,1,280
2025-09-09T04:26:29Z,pre_sentiment,gpt-4.1-mini,282,1,283
2025-09-09T04:26:29Z,pre_sentiment,gpt-4.1-mini,282,1,283
2025-09-09T04:26:31Z,sentiment,gpt-4.1-mini,1872,184,2056
2025-09-09T04:26:32Z,pre_sentiment,gpt-4.1-mini,280,1,281
2025-09-09T04:26:35Z,sentiment,gpt-4.1-mini,1633,226,1859
2025-09-09T04:26:36Z,pre_sentiment,gpt-4.1-mini,283,1,284
2025-09-09T04:26:39Z,sentiment,gpt-4.1-mini,1364,202,1566
2025-09-09T04:26:39Z,pre_sentiment,gpt-4.1-mini,285,1,286
2025-09-09T04:26:41Z,sentiment,gpt-4.1-mini,1334,177,1511
2025-09-09T04:26:42Z,pre_sentiment,gpt-4.1-mini,282,1,283
2025-09-09T04:26:45Z,sentiment,gpt-4.1-mini,1700,191,1891
2025-09-09T04:26:45Z,pre_sentiment,gpt-4.1-mini,284,1,285
2025-09-09T04:26:48Z,sentiment,gpt-4.1-mini,1731,224,1955
2025-09-09T04:26:49Z,pre_sentiment,gpt-4.1-mini,273,1,274
2025-09-09T04:26:51Z,sentiment,gpt-4.1-mini,1409,202,1611
2025-09-09T04:26:52Z,pre_sentiment,gpt-4.1-mini,275,1,276
2025-09-09T04:26:55Z,sentiment,gpt-4.1-mini,1898,232,2130
2025-09-09T04:26:56Z,pre_sentiment,gpt-4.1-mini,281,1,282
2025-09-09T04:26:59Z,sentiment,gpt-4.1-mini,1808,205,2013
2025-09-09T04:26:59Z,pre_sentiment,gpt-4.1-mini,281,1,282
2025-09-09T04:27:02Z,sentiment,gpt-4.1-mini,1355,214,1569
2025-09-09T04:27:02Z,pre_sentiment,gpt-4.1-mini,284,1,285
2025-09-09T04:27:17Z,pre_sentiment,gpt-4.1-mini,308,1,309
2025-09-09T04:27:19Z,sentiment,gpt-4.1-mini,1085,180,1265
2025-09-09T04:27:20Z,pre_sentiment,gpt-4.1-mini,303,1,304
2025-09-09T04:27:22Z,sentiment,gpt-4.1-mini,1185,161,1346
2025-09-09T04:27:22Z,pre_sentiment,gpt-4.1-mini,294,1,295
2025-09-09T04:27:25Z,sentiment,gpt-4.1-mini,964,164,1128
2025-09-09T04:27:25Z,pre_sentiment,gpt-4.1-mini,296,1,297
2025-09-09T04:27:27Z,sentiment,gpt-4.1-mini,1193,134,1327
2025-09-09T04:27:27Z,pre_sentiment,gpt-4.1-mini,301,1,302
2025-09-09T04:27:30Z,sentiment,gpt-4.1-mini,1564,211,1775
2025-09-09T04:27:30Z,pre_sentiment,gpt-4.1-mini,296,1,297
2025-09-09T04:27:34Z,sentiment,gpt-4.1-mini,2015,229,2244
2025-09-09T04:27:34Z,pre_sentiment,gpt-4.1-mini,300,1,301
2025-09-09T04:27:36Z,sentiment,gpt-4.1-mini,3357,148,3505
2025-09-09T04:27:37Z,pre_sentiment,gpt-4.1-mini,299,1,300
2025-09-09T04:27:40Z,sentiment,gpt-4.1-mini,2833,235,3068
2025-09-09T04:27:41Z,pre_sentiment,gpt-4.1-mini,294,1,295
2025-09-09T04:27:43Z,sentiment,gpt-4.1-mini,2013,178,2191
2025-09-09T04:27:43Z,pre_sentiment,gpt-4.1-mini,295,1,296
2025-09-09T04:27:48Z,sentiment,gpt-4.1-mini,2103,168,2271
2025-09-09T04:27:48Z,pre_sentiment,gpt-4.1-mini,299,1,300
2025-09-09T04:27:50Z,sentiment,gpt-4.1-mini,1234,157,1391
2025-09-09T04:27:50Z,pre_sentiment,gpt-4.1-mini,299,1,300
2025-09-09T04:27:52Z,sentiment,gpt-4.1-mini,1015,105,1120
2025-09-09T04:27:53Z,pre_sentiment,gpt-4.1-mini,310,1,311
2025-09-09T04:27:54Z,sentiment,gpt-4.1-mini,1058,135,1193
2025-09-09T04:27:55Z,pre_sentiment,gpt-4.1-mini,308,1,309
2025-09-09T04:27:57Z,sentiment,gpt-4.1-mini,932,107,1039
2025-09-09T04:28:07Z,pre_sentiment,gpt-4.1-mini,283,1,284
2025-09-09T04:28:10Z,sentiment,gpt-4.1-mini,2130,180,2310
2025-09-09T04:28:14Z,pre_sentiment,gpt-4.1-mini,285,1,286
2025-09-09T04:28:17Z,sentiment,gpt-4.1-mini,1284,184,1468
2025-09-09T04:28:17Z,pre_sentiment,gpt-4.1-mini,304,1,305
2025-09-09T04:28:19Z,sentiment,gpt-4.1-mini,2311,144,2455
2025-09-09T04:28:20Z,pre_sentiment,gpt-4.1-mini,290,1,291
2025-09-09T04:28:22Z,sentiment,gpt-4.1-mini,1400,144,1544
2025-09-09T04:28:23Z,pre_sentiment,gpt-4.1-mini,283,1,284
2025-09-09T04:28:25Z,sentiment,gpt-4.1-mini,1203,150,1353
2025-09-09T04:28:25Z,pre_sentiment,gpt-4.1-mini,299,1,300
2025-09-09T04:28:29Z,sentiment,gpt-4.1-mini,2382,226,2608
2025-09-09T04:28:29Z,pre_sentiment,gpt-4.1-mini,279,1,280
2025-09-09T04:28:32Z,sentiment,gpt-4.1-mini,1514,166,1680
2025-09-09T04:28:32Z,pre_sentiment,gpt-4.1-mini,305,1,306
2025-09-09T04:28:34Z,sentiment,gpt-4.1-mini,944,95,1039
2025-09-09T04:28:39Z,pre_sentiment,gpt-4.1-mini,286,1,287
2025-09-09T04:28:43Z,sentiment,gpt-4.1-mini,1331,223,1554
2025-09-09T04:28:43Z,pre_sentiment,gpt-4.1-mini,286,1,287
2025-09-09T04:28:46Z,sentiment,gpt-4.1-mini,2663,213,2876
2025-09-09T04:28:51Z,pre_sentiment,gpt-4.1-mini,294,1,295
2025-09-09T04:28:56Z,pre_sentiment,gpt-4.1-mini,274,1,275
2025-09-09T04:29:03Z,pre_sentiment,gpt-4.1-mini,285,1,286
2025-09-09T04:29:06Z,sentiment,gpt-4.1-mini,3679,220,3899
2025-09-09T04:29:07Z,pre_sentiment,gpt-4.1-mini,277,1,278
2025-09-09T04:29:09Z,sentiment,gpt-4.1-mini,1769,197,1966
2025-09-09T04:29:10Z,pre_sentiment,gpt-4.1-mini,283,1,284
2025-09-09T04:29:10Z,pre_sentiment,gpt-4.1-mini,294,1,295
2025-09-09T04:29:13Z,sentiment,gpt-4.1-mini,1922,202,2124
2025-09-09T04:29:14Z,pre_sentiment,gpt-4.1-mini,288,1,289
2025-09-09T04:29:16Z,sentiment,gpt-4.1-mini,1386,147,1533
2025-09-09T04:29:16Z,pre_sentiment,gpt-4.1-mini,283,1,284
2025-09-09T04:29:20Z,sentiment,gpt-4.1-mini,4314,211,4525
2025-09-09T04:29:20Z,pre_sentiment,gpt-4.1-mini,276,1,277
2025-09-09T04:29:22Z,sentiment,gpt-4.1-mini,1344,174,1518
2025-09-09T04:29:32Z,pre_sentiment,gpt-4.1-mini,291,1,292
2025-09-09T04:29:34Z,sentiment,gpt-4.1-mini,1105,171,1276
2025-09-09T04:29:34Z,pre_sentiment,gpt-4.1-mini,282,1,283
2025-09-09T04:29:35Z,pre_sentiment,gpt-4.1-mini,278,1,279
2025-09-09T04:29:35Z,pre_sentiment,gpt-4.1-mini,289,1,290
2025-09-09T04:29:37Z,sentiment,gpt-4.1-mini,1170,122,1292
2025-09-09T04:29:48Z,pre_sentiment,gpt-4.1-mini,287,1,288
2025-09-09T04:29:49Z,sentiment,gpt-4.1-mini,1054,118,1172
2025-09-09T04:29:53Z,pre_sentiment,gpt-4.1-mini,282,1,283
2025-09-09T04:29:53Z,pre_sentiment,gpt-4.1-mini,278,1,279
2025-09-09T04:29:54Z,pre_sentiment,gpt-4.1-mini,289,1,290
2025-09-09T04:29:56Z,sentiment,gpt-4.1-mini,1170,130,1300
2025-09-09T04:30:14Z,pre_sentiment,gpt-4.1-mini,286,1,287
2025-09-09T04:30:17Z,sentiment,gpt-4.1-mini,1732,134,1866
2025-09-09T04:30:24Z,pre_sentiment,gpt-4.1-mini,286,1,287
2025-09-09T04:30:24Z,pre_sentiment,gpt-4.1-mini,272,1,273
2025-09-09T04:30:27Z,sentiment,gpt-4.1-mini,1223,124,1347
2025-09-09T04:30:27Z,pre_sentiment,gpt-4.1-mini,301,1,302
2025-09-09T04:30:34Z,pre_sentiment,gpt-4.1-mini,278,1,279
2025-09-09T04:30:34Z,pre_sentiment,gpt-4.1-mini,290,1,291
2025-09-09T04:30:38Z,sentiment,gpt-4.1-mini,1536,255,1791
2025-09-09T04:30:38Z,pre_sentiment,gpt-4.1-mini,282,1,283
2025-09-09T04:30:39Z,pre_sentiment,gpt-4.1-mini,287,1,288
2025-09-09T04:30:39Z,pre_sentiment,gpt-4.1-mini,291,1,292
2025-09-09T04:30:51Z,pre_sentiment,gpt-4.1-mini,280,1,281
2025-09-09T04:30:54Z,sentiment,gpt-4.1-mini,2018,178,2196
2025-09-09T04:30:54Z,pre_sentiment,gpt-4.1-mini,289,1,290
2025-09-09T04:30:55Z,pre_sentiment,gpt-4.1-mini,288,1,289
2025-09-09T04:30:55Z,pre_sentiment,gpt-4.1-mini,283,1,284
2025-09-09T04:31:07Z,pre_sentiment,gpt-4.1-mini,288,1,289
2025-09-09T04:31:07Z,pre_sentiment,gpt-4.1-mini,281,1,282
2025-09-09T04:31:08Z,pre_sentiment,gpt-4.1-mini,291,1,292
2025-09-09T04:31:10Z,sentiment,gpt-4.1-mini,1125,178,1303
2025-09-09T04:31:10Z,pre_sentiment,gpt-4.1-mini,283,1,284
2025-09-09T04:31:11Z,pre_sentiment,gpt-4.1-mini,280,1,281
2025-09-09T04:31:11Z,pre_sentiment,gpt-4.1-mini,281,1,282
2025-09-09T04:31:11Z,pre_sentiment,gpt-4.1-mini,281,1,282
2025-09-09T04:31:12Z,pre_sentiment,gpt-4.1-mini,286,1,287
2025-09-09T04:31:12Z,pre_sentiment,gpt-4.1-mini,283,1,284
2025-09-09T04:31:12Z,pre_sentiment,gpt-4.1-mini,280,1,281
2025-09-09T04:31:13Z,pre_sentiment,gpt-4.1-mini,278,1,279
2025-09-09T04:31:21Z,article_selection,gpt-4.1-mini,1850,9,1859
2025-09-09T04:31:22Z,article_selection,gpt-4.1-mini,1383,16,1399
2025-09-09T04:31:22Z,article_selection,gpt-4.1-mini,753,9,762
2025-09-09T04:31:22Z,article_selection,gpt-4.1-mini,487,13,500
2025-09-09T04:31:41Z,final_summary_en,gpt-4.1-mini,963,1017,1980
2025-09-09T04:31:53Z,final_summary_en,gpt-4.1-mini,1623,1084,2707
2025-09-09T04:32:04Z,final_summary_en,gpt-4.1-mini,1115,919,2034
2025-09-09T04:32:22Z,final_summary_en,gpt-4.1-mini,1676,1317,2993
2025-09-09T04:32:35Z,final_summary_en,gpt-4.1-mini,1450,1165,2615
2025-09-09T04:32:49Z,final_summary_en,gpt-4.1-mini,1565,1026,2591
2025-09-09T04:33:02Z,final_summary_en,gpt-4.1-mini,827,1062,1889
2025-09-09T04:33:18Z,final_summary_en,gpt-4.1-mini,1787,1057,2844
2025-09-09T04:33:32Z,final_summary_en,gpt-4.1-mini,1345,951,2296
2025-09-09T04:33:52Z,final_summary_en,gpt-4.1-mini,1024,1075,2099
2025-09-09T04:34:18Z,final_summary_en,gpt-4.1-mini,2152,1392,3544
2025-09-09T04:34:38Z,final_summary_en,gpt-4.1-mini,4066,1332,5398
2025-09-09T04:34:54Z,final_summary_en,gpt-4.1-mini,705,780,1485
2025-09-09T04:35:09Z,final_summary_en,gpt-4.1-mini,1086,1035,2121
2025-09-09T04:35:25Z,final_summary_en,gpt-4.1-mini,1339,1015,2354
2025-09-09T04:36:14Z,category_summary,gpt-4.1-mini,127,39,166
2025-09-09T04:36:17Z,category_summary,gpt-4.1-mini,133,29,162
2025-09-09T04:36:18Z,category_summary,gpt-4.1-mini,106,26,132
2025-09-09T04:36:20Z,category_summary,gpt-4.1-mini,92,21,113
2025-09-09T04:36:22Z,category_summary,gpt-4.1-mini,125,40,165
2025-09-09T04:36:23Z,RUN_TOTAL,,139196,25354,164550
2025-09-10T04:24:13Z,pre_sentiment,gpt-4.1-mini,284,1,285
2025-09-10T04:24:14Z,pre_sentiment,gpt-4.1-mini,282,1,283
2025-09-10T04:24:15Z,pre_sentiment,gpt-4.1-mini,278,1,279
2025-09-10T04:24:16Z,pre_sentiment,gpt-4.1-mini,284,1,285
2025-09-10T04:24:16Z,pre_sentiment,gpt-4.1-mini,283,1,284
2025-09-10T04:24:21Z,sentiment,gpt-4.1-mini,1807,204,2011
2025-09-10T04:24:21Z,pre_sentiment,gpt-4.1-mini,292,1,293
2025-09-10T04:24:21Z,pre_sentiment,gpt-4.1-mini,278,1,279
2025-09-10T04:24:25Z,sentiment,gpt-4.1-mini,1517,219,1736
2025-09-10T04:24:26Z,pre_sentiment,gpt-4.1-mini,283,1,284
2025-09-10T04:24:26Z,pre_sentiment,gpt-4.1-mini,284,1,285
2025-09-10T04:24:27Z,pre_sentiment,gpt-4.1-mini,275,1,276
2025-09-10T04:24:27Z,pre_sentiment,gpt-4.1-mini,275,1,276
2025-09-10T04:24:27Z,pre_sentiment,gpt-4.1-mini,287,1,288
2025-09-10T04:24:28Z,pre_sentiment,gpt-4.1-mini,287,1,288
2025-09-10T04:24:34Z,pre_sentiment,gpt-4.1-mini,285,1,286
2025-09-10T04:24:35Z,pre_sentiment,gpt-4.1-mini,279,1,280
2025-09-10T04:24:42Z,pre_sentiment,gpt-4.1-mini,283,1,284
2025-09-10T04:24:42Z,pre_sentiment,gpt-4.1-mini,286,1,287
2025-09-10T04:24:46Z,sentiment,gpt-4.1-mini,1326,205,1531
2025-09-10T04:24:51Z,pre_sentiment,gpt-4.1-mini,288,1,289
2025-09-10T04:24:54Z,sentiment,gpt-4.1-mini,2019,165,2184
2025-09-10T04:24:54Z,pre_sentiment,gpt-4.1-mini,284,1,285
2025-09-10T04:24:54Z,pre_sentiment,gpt-4.1-mini,280,1,281
2025-09-10T04:24:57Z,sentiment,gpt-4.1-mini,1390,175,1565
2025-09-10T04:24:57Z,pre_sentiment,gpt-4.1-mini,283,1,284
2025-09-10T04:24:58Z,pre_sentiment,gpt-4.1-mini,282,1,283
2025-09-10T04:24:58Z,pre_sentiment,gpt-4.1-mini,286,1,287
2025-09-10T04:25:01Z,sentiment,gpt-4.1-mini,1596,189,1785
2025-09-10T04:25:01Z,pre_sentiment,gpt-4.1-mini,282,1,283
2025-09-10T04:25:02Z,pre_sentiment,gpt-4.1-mini,284,1,285
2025-09-10T04:25:04Z,sentiment,gpt-4.1-mini,2344,186,2530
2025-09-10T04:25:04Z,pre_sentiment,gpt-4.1-mini,281,1,282
2025-09-10T04:25:07Z,sentiment,gpt-4.1-mini,2318,195,2513
2025-09-10T04:25:08Z,pre_sentiment,gpt-4.1-mini,277,1,278
2025-09-10T04:25:10Z,sentiment,gpt-4.1-mini,1405,189,1594
2025-09-10T04:25:10Z,pre_sentiment,gpt-4.1-mini,281,1,282
2025-09-10T04:25:14Z,sentiment,gpt-4.1-mini,1450,206,1656
2025-09-10T04:25:14Z,pre_sentiment,gpt-4.1-mini,282,1,283
2025-09-10T04:25:14Z,pre_sentiment,gpt-4.1-mini,280,1,281
2025-09-10T04:25:18Z,sentiment,gpt-4.1-mini,1633,228,1861
2025-09-10T04:25:33Z,pre_sentiment,gpt-4.1-mini,293,1,294
2025-09-10T04:25:35Z,sentiment,gpt-4.1-mini,902,105,1007
2025-09-10T04:25:35Z,pre_sentiment,gpt-4.1-mini,292,1,293
2025-09-10T04:25:37Z,sentiment,gpt-4.1-mini,901,85,986
2025-09-10T04:25:37Z,pre_sentiment,gpt-4.1-mini,294,1,295
2025-09-10T04:25:40Z,sentiment,gpt-4.1-mini,980,185,1165
2025-09-10T04:25:40Z,pre_sentiment,gpt-4.1-mini,295,1,296
2025-09-10T04:25:42Z,sentiment,gpt-4.1-mini,934,101,1035
2025-09-10T04:25:42Z,pre_sentiment,gpt-4.1-mini,296,1,297
2025-09-10T04:25:45Z,sentiment,gpt-4.1-mini,970,190,1160
2025-09-10T04:25:45Z,pre_sentiment,gpt-4.1-mini,301,1,302
2025-09-10T04:25:48Z,sentiment,gpt-4.1-mini,2620,194,2814
2025-09-10T04:25:48Z,pre_sentiment,gpt-4.1-mini,298,1,299
2025-09-10T04:25:51Z,sentiment,gpt-4.1-mini,1685,184,1869
2025-09-10T04:25:51Z,pre_sentiment,gpt-4.1-mini,296,1,297
2025-09-10T04:25:56Z,sentiment,gpt-4.1-mini,2980,212,3192
2025-09-10T04:25:57Z,pre_sentiment,gpt-4.1-mini,301,1,302
2025-09-10T04:25:59Z,sentiment,gpt-4.1-mini,1568,142,1710
2025-09-10T04:26:00Z,pre_sentiment,gpt-4.1-mini,301,1,302
2025-09-10T04:26:02Z,sentiment,gpt-4.1-mini,1311,170,1481
2025-09-10T04:26:03Z,pre_sentiment,gpt-4.1-mini,295,1,296
2025-09-10T04:26:03Z,pre_sentiment,gpt-4.1-mini,301,1,302
2025-09-10T04:26:06Z,sentiment,gpt-4.1-mini,1157,152,1309
2025-09-10T04:26:06Z,pre_sentiment,gpt-4.1-mini,296,1,297
2025-09-10T04:26:09Z,sentiment,gpt-4.1-mini,1193,132,1325
2025-09-10T04:26:27Z,pre_sentiment,gpt-4.1-mini,277,1,278
2025-09-10T04:26:29Z,sentiment,gpt-4.1-mini,1364,178,1542
2025-09-10T04:26:30Z,pre_sentiment,gpt-4.1-mini,286,1,287
2025-09-10T04:26:32Z,sentiment,gpt-4.1-mini,1054,119,1173
2025-09-10T04:26:32Z,pre_sentiment,gpt-4.1-mini,284,1,285
2025-09-10T04:26:35Z,sentiment,gpt-4.1-mini,2008,194,2202
2025-09-10T04:26:35Z,pre_sentiment,gpt-4.1-mini,287,1,288
2025-09-10T04:26:38Z,sentiment,gpt-4.1-mini,2436,190,2626
2025-09-10T04:26:39Z,pre_sentiment,gpt-4.1-mini,295,1,296
2025-09-10T04:26:40Z,sentiment,gpt-4.1-mini,887,121,1008
2025-09-10T04:26:41Z,pre_sentiment,gpt-4.1-mini,286,1,287
2025-09-10T04:26:43Z,sentiment,gpt-4.1-mini,2058,190,2248
2025-09-10T04:26:43Z,pre_sentiment,gpt-4.1-mini,289,1,290
2025-09-10T04:26:46Z,sentiment,gpt-4.1-mini,1303,149,1452
2025-09-10T04:26:46Z,pre_sentiment,gpt-4.1-mini,284,1,285
2025-09-10T04:26:50Z,sentiment,gpt-4.1-mini,1894,205,2099
2025-09-10T04:26:50Z,pre_sentiment,gpt-4.1-mini,286,1,287
2025-09-10T04:26:53Z,sentiment,gpt-4.1-mini,2625,210,2835
2025-09-10T04:26:57Z,pre_sentiment,gpt-4.1-mini,283,1,284
2025-09-10T04:26:59Z,sentiment,gpt-4.1-mini,1575,199,1774
2025-09-10T04:27:22Z,pre_sentiment,gpt-4.1-mini,282,1,283
2025-09-10T04:27:25Z,sentiment,gpt-4.1-mini,3106,202,3308
2025-09-10T04:27:30Z,pre_sentiment,gpt-4.1-mini,275,1,276
2025-09-10T04:27:30Z,pre_sentiment,gpt-4.1-mini,276,1,277
2025-09-10T04:27:31Z,pre_sentiment,gpt-4.1-mini,275,1,276
2025-09-10T04:27:31Z,pre_sentiment,gpt-4.1-mini,281,1,282
2025-09-10T04:27:38Z,pre_sentiment,gpt-4.1-mini,285,1,286
2025-09-10T04:27:40Z,sentiment,gpt-4.1-mini,1607,176,1783
2025-09-10T04:27:40Z,pre_sentiment,gpt-4.1-mini,290,1,291
2025-09-10T04:27:40Z,pre_sentiment,gpt-4.1-mini,279,1,280
2025-09-10T04:27:42Z,sentiment,gpt-4.1-mini,3275,146,3421
2025-09-10T04:27:43Z,pre_sentiment,gpt-4.1-mini,284,1,285
2025-09-10T04:27:45Z,sentiment,gpt-4.1-mini,3204,170,3374
2025-09-10T04:27:46Z,pre_sentiment,gpt-4.1-mini,284,1,285
2025-09-10T04:28:07Z,pre_sentiment,gpt-4.1-mini,292,1,293
2025-09-10T04:28:29Z,pre_sentiment,gpt-4.1-mini,287,1,288
2025-09-10T04:28:32Z,sentiment,gpt-4.1-mini,1396,207,1603
2025-09-10T04:28:32Z,pre_sentiment,gpt-4.1-mini,288,1,289
2025-09-10T04:28:35Z,sentiment,gpt-4.1-mini,1927,156,2083
2025-09-10T04:28:36Z,pre_sentiment,gpt-4.1-mini,291,1,292
2025-09-10T04:28:38Z,sentiment,gpt-4.1-mini,1615,136,1751
2025-09-10T04:28:38Z,pre_sentiment,gpt-4.1-mini,284,1,285
2025-09-10T04:28:42Z,sentiment,gpt-4.1-mini,1454,229,1683
2025-09-10T04:28:51Z,pre_sentiment,gpt-4.1-mini,284,1,285
2025-09-10T04:28:53Z,sentiment,gpt-4.1-mini,1509,187,1696
2025-09-10T04:28:53Z,pre_sentiment,gpt-4.1-mini,292,1,293
2025-09-10T04:28:54Z,pre_sentiment,gpt-4.1-mini,289,1,290
2025-09-10T04:28:54Z,pre_sentiment,gpt-4.1-mini,289,1,290
2025-09-10T04:28:56Z,sentiment,gpt-4.1-mini,1431,196,1627
2025-09-10T04:28:57Z,pre_sentiment,gpt-4.1-mini,285,1,286
2025-09-10T04:29:00Z,sentiment,gpt-4.1-mini,1345,175,1520
2025-09-10T04:29:00Z,pre_sentiment,gpt-4.1-mini,293,1,294
2025-09-10T04:29:00Z,pre_sentiment,gpt-4.1-mini,272,1,273
2025-09-10T04:29:03Z,sentiment,gpt-4.1-mini,1827,173,2000
2025-09-10T04:29:11Z,pre_sentiment,gpt-4.1-mini,288,1,289
2025-09-10T04:29:12Z,pre_sentiment,gpt-4.1-mini,293,1,294
2025-09-10T04:29:17Z,sentiment,gpt-4.1-mini,1878,223,2101
2025-09-10T04:29:17Z,pre_sentiment,gpt-4.1-mini,286,1,287
2025-09-10T04:29:17Z,pre_sentiment,gpt-4.1-mini,295,1,296
2025-09-10T04:29:18Z,pre_sentiment,gpt-4.1-mini,283,1,284
2025-09-10T04:29:18Z,pre_sentiment,gpt-4.1-mini,284,1,285
2025-09-10T04:29:21Z,sentiment,gpt-4.1-mini,1797,206,2003
2025-09-10T04:29:21Z,pre_sentiment,gpt-4.1-mini,284,1,285
2025-09-10T04:29:21Z,pre_sentiment,gpt-4.1-mini,285,1,286
2025-09-10T04:29:22Z,pre_sentiment,gpt-4.1-mini,285,1,286
2025-09-10T04:29:34Z,pre_sentiment,gpt-4.1-mini,289,1,290
2025-09-10T04:29:38Z,sentiment,gpt-4.1-mini,2180,181,2361
2025-09-10T04:29:38Z,pre_sentiment,gpt-4.1-mini,288,1,289
2025-09-10T04:29:39Z,pre_sentiment,gpt-4.1-mini,280,1,281
2025-09-10T04:29:41Z,sentiment,gpt-4.1-mini,2018,148,2166
2025-09-10T04:29:41Z,pre_sentiment,gpt-4.1-mini,289,1,290
2025-09-10T04:29:53Z,pre_sentiment,gpt-4.1-mini,285,1,286
2025-09-10T04:29:54Z,sentiment,gpt-4.1-mini,1101,131,1232
2025-09-10T04:29:55Z,pre_sentiment,gpt-4.1-mini,287,1,288
2025-09-10T04:29:55Z,pre_sentiment,gpt-4.1-mini,283,1,284
2025-09-10T04:29:55Z,pre_sentiment,gpt-4.1-mini,282,1,283
2025-09-10T04:29:56Z,pre_sentiment,gpt-4.1-mini,276,1,277
2025-09-10T04:29:58Z,sentiment,gpt-4.1-mini,1009,207,1216
2025-09-10T04:29:59Z,pre_sentiment,gpt-4.1-mini,279,1,280
2025-09-10T04:30:02Z,sentiment,gpt-4.1-mini,1528,199,1727
2025-09-10T04:30:02Z,pre_sentiment,gpt-4.1-mini,290,1,291
2025-09-10T04:30:05Z,sentiment,gpt-4.1-mini,1433,162,1595
2025-09-10T04:30:05Z,pre_sentiment,gpt-4.1-mini,290,1,291
2025-09-10T04:30:06Z,pre_sentiment,gpt-4.1-mini,290,1,291
2025-09-10T04:30:06Z,pre_sentiment,gpt-4.1-mini,282,1,283
2025-09-10T04:30:09Z,sentiment,gpt-4.1-mini,1456,169,1625
2025-09-10T04:30:09Z,pre_sentiment,gpt-4.1-mini,286,1,287
2025-09-10T04:30:09Z,pre_sentiment,gpt-4.1-mini,285,1,286
2025-09-10T04:30:12Z,sentiment,gpt-4.1-mini,1279,170,1449
2025-09-10T04:30:24Z,article_selection,gpt-4.1-mini,1159,9,1168
2025-09-10T04:30:25Z,article_selection,gpt-4.1-mini,1066,9,1075
2025-09-10T04:30:25Z,article_selection,gpt-4.1-mini,840,12,852
2025-09-10T04:30:26Z,article_selection,gpt-4.1-mini,1626,16,1642
2025-09-10T04:30:26Z,article_selection,gpt-4.1-mini,1238,16,1254
2025-09-10T04:30:46Z,final_summary_en,gpt-4.1-mini,1269,1009,2278
2025-09-10T04:31:02Z,final_summary_en,gpt-4.1-mini,1084,1112,2196
2025-09-10T04:31:20Z,final_summary_en,gpt-4.1-mini,1234,1171,2405
2025-09-10T04:31:36Z,final_summary_en,gpt-4.1-mini,1405,1171,2576
2025-09-10T04:31:59Z,final_summary_en,gpt-4.1-mini,2092,1250,3342
2025-09-10T04:32:25Z,final_summary_en,gpt-4.1-mini,2377,1490,3867
2025-09-10T04:32:41Z,final_summary_en,gpt-4.1-mini,1755,1104,2859
2025-09-10T04:33:14Z,final_summary_en,gpt-4.1-mini,2180,1368,3548
2025-09-10T04:33:31Z,final_summary_en,gpt-4.1-mini,1146,1146,2292
2025-09-10T04:33:46Z,final_summary_en,gpt-4.1-mini,1210,957,2167
2025-09-10T04:34:02Z,final_summary_en,gpt-4.1-mini,1112,1003,2115
2025-09-10T04:34:18Z,final_summary_en,gpt-4.1-mini,1569,1039,2608
2025-09-10T04:34:34Z,final_summary_en,gpt-4.1-mini,2743,1238,3981
2025-09-10T04:34:51Z,final_summary_en,gpt-4.1-mini,1155,1082,2237
2025-09-10T04:35:07Z,final_summary_en,gpt-4.1-mini,1182,1155,2337
2025-09-10T04:35:30Z,final_summary_en,gpt-4.1-mini,1075,1329,2404
2025-09-10T04:35:47Z,final_summary_en,gpt-4.1-mini,1538,1266,2804
2025-09-10T04:36:06Z,final_summary_en,gpt-4.1-mini,2369,964,3333
2025-09-10T04:36:43Z,final_summary_en,gpt-4.1-mini,1918,1184,3102
2025-09-10T04:37:05Z,final_summary_en,gpt-4.1-mini,1629,1189,2818
2025-09-10T04:37:23Z,final_summary_en,gpt-4.1-mini,1423,1030,2453
2025-09-10T04:38:26Z,category_summary,gpt-4.1-mini,125,36,161
2025-09-10T04:38:28Z,category_summary,gpt-4.1-mini,134,42,176
2025-09-10T04:38:30Z,category_summary,gpt-4.1-mini,122,31,153
2025-09-10T04:38:32Z,category_summary,gpt-4.1-mini,141,42,183
2025-09-10T04:38:34Z,category_summary,gpt-4.1-mini,130,40,170
2025-09-10T04:38:35Z,category_summary,gpt-4.1-mini,86,19,105
2025-09-10T04:38:36Z,RUN_TOTAL,,161309,34346,195655
2025-09-11T04:25:10Z,pre_sentiment,gpt-4.1-mini,281,1,282
2025-09-11T04:25:10Z,pre_sentiment,gpt-4.1-mini,286,1,287
2025-09-11T04:25:11Z,pre_sentiment,gpt-4.1-mini,284,1,285
2025-09-11T04:25:12Z,pre_sentiment,gpt-4.1-mini,295,1,296
2025-09-11T04:25:12Z,pre_sentiment,gpt-4.1-mini,297,1,298
2025-09-11T04:25:13Z,pre_sentiment,gpt-4.1-mini,292,1,293
2025-09-11T04:25:15Z,sentiment,gpt-4.1-mini,1374,112,1486
2025-09-11T04:25:16Z,pre_sentiment,gpt-4.1-mini,279,1,280
2025-09-11T04:25:16Z,pre_sentiment,gpt-4.1-mini,283,1,284
2025-09-11T04:25:17Z,pre_sentiment,gpt-4.1-mini,285,1,286
2025-09-11T04:25:19Z,sentiment,gpt-4.1-mini,1565,174,1739
2025-09-11T04:25:20Z,pre_sentiment,gpt-4.1-mini,288,1,289
2025-09-11T04:25:20Z,pre_sentiment,gpt-4.1-mini,287,1,288
2025-09-11T04:25:23Z,sentiment,gpt-4.1-mini,1486,124,1610
2025-09-11T04:25:23Z,pre_sentiment,gpt-4.1-mini,282,1,283
2025-09-11T04:25:23Z,pre_sentiment,gpt-4.1-mini,282,1,283
2025-09-11T04:25:24Z,pre_sentiment,gpt-4.1-mini,277,1,278
2025-09-11T04:25:37Z,pre_sentiment,gpt-4.1-mini,276,1,277
2025-09-11T04:25:37Z,pre_sentiment,gpt-4.1-mini,285,1,286
2025-09-11T04:25:49Z,pre_sentiment,gpt-4.1-mini,285,1,286
2025-09-11T04:25:53Z,sentiment,gpt-4.1-mini,1565,144,1709
2025-09-11T04:25:53Z,pre_sentiment,gpt-4.1-mini,285,1,286
2025-09-11T04:25:56Z,sentiment,gpt-4.1-mini,1706,235,1941
2025-09-11T04:26:00Z,pre_sentiment,gpt-4.1-mini,280,1,281
2025-09-11T04:26:03Z,sentiment,gpt-4.1-mini,1509,237,1746
2025-09-11T04:26:03Z,pre_sentiment,gpt-4.1-mini,281,1,282
2025-09-11T04:26:06Z,sentiment,gpt-4.1-mini,1501,201,1702
2025-09-11T04:26:07Z,pre_sentiment,gpt-4.1-mini,282,1,283
2025-09-11T04:26:09Z,sentiment,gpt-4.1-mini,1575,206,1781
2025-09-11T04:26:10Z,pre_sentiment,gpt-4.1-mini,281,1,282
2025-09-11T04:26:12Z,sentiment,gpt-4.1-mini,1417,193,1610
2025-09-11T04:26:13Z,pre_sentiment,gpt-4.1-mini,283,1,284
2025-09-11T04:26:16Z,sentiment,gpt-4.1-mini,1479,191,1670
2025-09-11T04:26:17Z,pre_sentiment,gpt-4.1-mini,287,1,288
2025-09-11T04:26:21Z,sentiment,gpt-4.1-mini,1724,216,1940
2025-09-11T04:26:21Z,pre_sentiment,gpt-4.1-mini,282,1,283
2025-09-11T04:26:24Z,sentiment,gpt-4.1-mini,2367,202,2569
2025-09-11T04:26:25Z,pre_sentiment,gpt-4.1-mini,288,1,289
2025-09-11T04:26:28Z,sentiment,gpt-4.1-mini,1574,213,1787
2025-09-11T04:26:29Z,pre_sentiment,gpt-4.1-mini,277,1,278
2025-09-11T04:26:31Z,sentiment,gpt-4.1-mini,1945,216,2161
2025-09-11T04:26:31Z,pre_sentiment,gpt-4.1-mini,277,1,278
2025-09-11T04:26:34Z,sentiment,gpt-4.1-mini,1407,182,1589
2025-09-11T04:26:34Z,pre_sentiment,gpt-4.1-mini,292,1,293
2025-09-11T04:26:37Z,sentiment,gpt-4.1-mini,1352,214,1566
2025-09-11T04:26:37Z,pre_sentiment,gpt-4.1-mini,276,1,277
2025-09-11T04:26:41Z,sentiment,gpt-4.1-mini,1935,202,2137
2025-09-11T04:26:42Z,pre_sentiment,gpt-4.1-mini,284,1,285
2025-09-11T04:27:01Z,pre_sentiment,gpt-4.1-mini,301,1,302
2025-09-11T04:27:02Z,sentiment,gpt-4.1-mini,920,97,1017
2025-09-11T04:27:03Z,pre_sentiment,gpt-4.1-mini,298,1,299
2025-09-11T04:27:03Z,pre_sentiment,gpt-4.1-mini,298,1,299
2025-09-11T04:27:05Z,sentiment,gpt-4.1-mini,912,106,1018
2025-09-11T04:27:06Z,pre_sentiment,gpt-4.1-mini,309,1,310
2025-09-11T04:27:06Z,pre_sentiment,gpt-4.1-mini,303,1,304
2025-09-11T04:27:09Z,sentiment,gpt-4.1-mini,4600,190,4790
2025-09-11T04:27:10Z,pre_sentiment,gpt-4.1-mini,299,1,300
2025-09-11T04:27:12Z,sentiment,gpt-4.1-mini,1721,174,1895
2025-09-11T04:27:13Z,pre_sentiment,gpt-4.1-mini,298,1,299
2025-09-11T04:27:17Z,sentiment,gpt-4.1-mini,4673,280,4953
2025-09-11T04:27:18Z,pre_sentiment,gpt-4.1-mini,298,1,299
2025-09-11T04:27:21Z,sentiment,gpt-4.1-mini,5036,205,5241
2025-09-11T04:27:21Z,pre_sentiment,gpt-4.1-mini,298,1,299
2025-09-11T04:27:25Z,sentiment,gpt-4.1-mini,9514,228,9742
2025-09-11T04:27:25Z,pre_sentiment,gpt-4.1-mini,295,1,296
2025-09-11T04:27:29Z,sentiment,gpt-4.1-mini,8497,242,8739
2025-09-11T04:27:29Z,pre_sentiment,gpt-4.1-mini,309,1,310
2025-09-11T04:27:33Z,sentiment,gpt-4.1-mini,5709,210,5919
2025-09-11T04:27:33Z,pre_sentiment,gpt-4.1-mini,295,1,296
2025-09-11T04:27:37Z,sentiment,gpt-4.1-mini,4063,211,4274
2025-09-11T04:27:38Z,pre_sentiment,gpt-4.1-mini,303,1,304
2025-09-11T04:27:43Z,sentiment,gpt-4.1-mini,10393,238,10631
2025-09-11T04:27:44Z,pre_sentiment,gpt-4.1-mini,302,1,303
2025-09-11T04:27:49Z,sentiment,gpt-4.1-mini,13495,215,13710
2025-09-11T04:27:49Z,pre_sentiment,gpt-4.1-mini,302,1,303
2025-09-11T04:27:52Z,sentiment,gpt-4.1-mini,6803,201,7004
2025-09-11T04:28:06Z,pre_sentiment,gpt-4.1-mini,281,1,282
2025-09-11T04:28:11Z,sentiment,gpt-4.1-mini,2122,177,2299
2025-09-11T04:28:11Z,pre_sentiment,gpt-4.1-mini,285,1,286
2025-09-11T04:28:15Z,sentiment,gpt-4.1-mini,4557,309,4866
2025-09-11T04:28:16Z,pre_sentiment,gpt-4.1-mini,286,1,287
2025-09-11T04:28:20Z,sentiment,gpt-4.1-mini,6774,260,7034
2025-09-11T04:28:20Z,pre_sentiment,gpt-4.1-mini,288,1,289
2025-09-11T04:28:22Z,sentiment,gpt-4.1-mini,1449,132,1581
2025-09-11T04:28:22Z,pre_sentiment,gpt-4.1-mini,280,1,281
2025-09-11T04:28:25Z,sentiment,gpt-4.1-mini,2309,227,2536
2025-09-11T04:28:26Z,pre_sentiment,gpt-4.1-mini,286,1,287
2025-09-11T04:28:28Z,sentiment,gpt-4.1-mini,2449,190,2639
2025-09-11T04:28:28Z,pre_sentiment,gpt-4.1-mini,289,1,290
2025-09-11T04:28:31Z,sentiment,gpt-4.1-mini,1504,189,1693
2025-09-11T04:28:32Z,pre_sentiment,gpt-4.1-mini,280,1,281
2025-09-11T04:28:33Z,sentiment,gpt-4.1-mini,1002,114,1116
2025-09-11T04:28:34Z,pre_sentiment,gpt-4.1-mini,290,1,291
2025-09-11T04:28:36Z,sentiment,gpt-4.1-mini,2382,158,2540
2025-09-11T04:28:36Z,pre_sentiment,gpt-4.1-mini,295,1,296
2025-09-11T04:28:39Z,sentiment,gpt-4.1-mini,1646,155,1801
2025-09-11T04:28:59Z,pre_sentiment,gpt-4.1-mini,286,1,287
2025-09-11T04:29:02Z,sentiment,gpt-4.1-mini,3374,196,3570
2025-09-11T04:29:02Z,pre_sentiment,gpt-4.1-mini,292,1,293
2025-09-11T04:29:04Z,sentiment,gpt-4.1-mini,1259,192,1451
2025-09-11T04:29:19Z,pre_sentiment,gpt-4.1-mini,266,1,267
2025-09-11T04:29:21Z,pre_sentiment,gpt-4.1-mini,279,1,280
2025-09-11T04:29:22Z,pre_sentiment,gpt-4.1-mini,266,1,267
2025-09-11T04:29:27Z,pre_sentiment,gpt-4.1-mini,279,1,280
2025-09-11T04:29:27Z,pre_sentiment,gpt-4.1-mini,271,1,272
2025-09-11T04:29:28Z,pre_sentiment,gpt-4.1-mini,275,1,276
2025-09-11T04:29:28Z,pre_sentiment,gpt-4.1-mini,272,1,273
2025-09-11T04:29:31Z,sentiment,gpt-4.1-mini,3123,232,3355
2025-09-11T04:29:32Z,pre_sentiment,gpt-4.1-mini,275,1,276
2025-09-11T04:29:32Z,pre_sentiment,gpt-4.1-mini,275,1,276
2025-09-11T04:29:33Z,pre_sentiment,gpt-4.1-mini,275,1,276
2025-09-11T04:29:33Z,pre_sentiment,gpt-4.1-mini,276,1,277
2025-09-11T04:29:39Z,pre_sentiment,gpt-4.1-mini,278,1,279
2025-09-11T04:29:41Z,sentiment,gpt-4.1-mini,1337,169,1506
2025-09-11T04:29:42Z,pre_sentiment,gpt-4.1-mini,280,1,281
2025-09-11T04:29:45Z,sentiment,gpt-4.1-mini,1680,219,1899
2025-09-11T04:29:46Z,pre_sentiment,gpt-4.1-mini,282,1,283
2025-09-11T04:29:48Z,sentiment,gpt-4.1-mini,1283,161,1444
2025-09-11T04:29:48Z,pre_sentiment,gpt-4.1-mini,285,1,286
2025-09-11T04:29:50Z,sentiment,gpt-4.1-mini,1673,148,1821
2025-09-11T04:29:51Z,pre_sentiment,gpt-4.1-mini,281,1,282
2025-09-11T04:29:55Z,sentiment,gpt-4.1-mini,1937,240,2177
2025-09-11T04:29:55Z,pre_sentiment,gpt-4.1-mini,283,1,284
2025-09-11T04:29:57Z,sentiment,gpt-4.1-mini,1960,211,2171
2025-09-11T04:29:58Z,pre_sentiment,gpt-4.1-mini,281,1,282
2025-09-11T04:30:01Z,sentiment,gpt-4.1-mini,2979,209,3188
2025-09-11T04:30:01Z,pre_sentiment,gpt-4.1-mini,287,1,288
2025-09-11T04:30:03Z,sentiment,gpt-4.1-mini,1506,175,1681
2025-09-11T04:30:04Z,pre_sentiment,gpt-4.1-mini,280,1,281
2025-09-11T04:30:06Z,sentiment,gpt-4.1-mini,1570,182,1752
2025-09-11T04:30:07Z,pre_sentiment,gpt-4.1-mini,285,1,286
2025-09-11T04:30:12Z,sentiment,gpt-4.1-mini,1607,173,1780
2025-09-11T04:30:31Z,pre_sentiment,gpt-4.1-mini,286,1,287
2025-09-11T04:30:53Z,pre_sentiment,gpt-4.1-mini,288,1,289
2025-09-11T04:30:56Z,sentiment,gpt-4.1-mini,1927,161,2088
2025-09-11T04:31:05Z,pre_sentiment,gpt-4.1-mini,289,1,290
2025-09-11T04:31:08Z,sentiment,gpt-4.1-mini,1353,207,1560
2025-09-11T04:31:09Z,pre_sentiment,gpt-4.1-mini,286,1,287
2025-09-11T04:31:14Z,sentiment,gpt-4.1-mini,1573,245,1818
2025-09-11T04:31:14Z,pre_sentiment,gpt-4.1-mini,298,1,299
2025-09-11T04:31:14Z,pre_sentiment,gpt-4.1-mini,288,1,289
2025-09-11T04:31:18Z,sentiment,gpt-4.1-mini,1354,207,1561
2025-09-11T04:31:18Z,pre_sentiment,gpt-4.1-mini,272,1,273
2025-09-11T04:31:21Z,sentiment,gpt-4.1-mini,1601,156,1757
2025-09-11T04:31:31Z,pre_sentiment,gpt-4.1-mini,287,1,288
2025-09-11T04:31:35Z,sentiment,gpt-4.1-mini,1496,245,1741
2025-09-11T04:31:35Z,pre_sentiment,gpt-4.1-mini,283,1,284
2025-09-11T04:31:35Z,pre_sentiment,gpt-4.1-mini,285,1,286
2025-09-11T04:31:36Z,pre_sentiment,gpt-4.1-mini,292,1,293
2025-09-11T04:31:39Z,sentiment,gpt-4.1-mini,1449,220,1669
2025-09-11T04:31:39Z,pre_sentiment,gpt-4.1-mini,286,1,287
2025-09-11T04:31:40Z,pre_sentiment,gpt-4.1-mini,292,1,293
2025-09-11T04:31:40Z,pre_sentiment,gpt-4.1-mini,280,1,281
2025-09-11T04:31:42Z,sentiment,gpt-4.1-mini,1357,179,1536
2025-09-11T04:31:56Z,pre_sentiment,gpt-4.1-mini,281,1,282
2025-09-11T04:31:56Z,pre_sentiment,gpt-4.1-mini,297,1,298
2025-09-11T04:32:09Z,pre_sentiment,gpt-4.1-mini,295,1,296
2025-09-11T04:32:10Z,pre_sentiment,gpt-4.1-mini,299,1,300
2025-09-11T04:32:12Z,sentiment,gpt-4.1-mini,1543,196,1739
2025-09-11T04:32:13Z,pre_sentiment,gpt-4.1-mini,299,1,300
2025-09-11T04:32:13Z,pre_sentiment,gpt-4.1-mini,292,1,293
2025-09-11T04:32:14Z,pre_sentiment,gpt-4.1-mini,285,1,286
2025-09-11T04:32:14Z,pre_sentiment,gpt-4.1-mini,284,1,285
2025-09-11T04:32:14Z,pre_sentiment,gpt-4.1-mini,289,1,290
2025-09-11T04:32:15Z,pre_sentiment,gpt-4.1-mini,282,1,283
2025-09-11T04:32:15Z,pre_sentiment,gpt-4.1-mini,288,1,289
2025-09-11T04:32:17Z,sentiment,gpt-4.1-mini,1138,107,1245
2025-09-11T04:32:17Z,pre_sentiment,gpt-4.1-mini,276,1,277
2025-09-11T04:32:18Z,pre_sentiment,gpt-4.1-mini,283,1,284
2025-09-11T04:32:18Z,pre_sentiment,gpt-4.1-mini,287,1,288
2025-09-11T04:32:20Z,sentiment,gpt-4.1-mini,1078,131,1209
2025-09-11T04:32:29Z,article_selection,gpt-4.1-mini,1321,12,1333
2025-09-11T04:32:29Z,article_selection,gpt-4.1-mini,2631,12,2643
2025-09-11T04:32:30Z,article_selection,gpt-4.1-mini,1182,16,1198
2025-09-11T04:32:30Z,article_selection,gpt-4.1-mini,2346,9,2355
2025-09-11T04:32:31Z,article_selection,gpt-4.1-mini,998,12,1010
2025-09-11T04:32:47Z,final_summary_en,gpt-4.1-mini,1487,1331,2818
2025-09-11T04:33:02Z,final_summary_en,gpt-4.1-mini,1166,1169,2335
2025-09-11T04:33:23Z,final_summary_en,gpt-4.1-mini,4467,1334,5801
2025-09-11T04:33:42Z,final_summary_en,gpt-4.1-mini,1712,1301,3013
2025-09-11T04:34:03Z,final_summary_en,gpt-4.1-mini,1274,1442,2716
2025-09-11T04:34:22Z,final_summary_en,gpt-4.1-mini,1682,1058,2740
2025-09-11T04:34:36Z,final_summary_en,gpt-4.1-mini,1443,912,2355
2025-09-11T04:34:54Z,final_summary_en,gpt-4.1-mini,1263,1119,2382
2025-09-11T04:35:06Z,final_summary_en,gpt-4.1-mini,1701,890,2591
2025-09-11T04:35:26Z,final_summary_en,gpt-4.1-mini,2085,1262,3347
2025-09-11T04:35:46Z,final_summary_en,gpt-4.1-mini,1112,1284,2396
2025-09-11T04:36:08Z,final_summary_en,gpt-4.1-mini,2120,1372,3492
2025-09-11T04:36:25Z,final_summary_en,gpt-4.1-mini,1004,1134,2138
2025-09-11T04:36:41Z,final_summary_en,gpt-4.1-mini,1344,1212,2556
2025-09-11T04:36:56Z,final_summary_en,gpt-4.1-mini,2903,1061,3964
2025-09-11T04:37:09Z,final_summary_en,gpt-4.1-mini,1295,1024,2319
2025-09-11T04:37:25Z,final_summary_en,gpt-4.1-mini,1076,1111,2187
2025-09-11T04:37:36Z,final_summary_en,gpt-4.1-mini,1018,896,1914
2025-09-11T04:37:51Z,final_summary_en,gpt-4.1-mini,1155,1044,2199
2025-09-11T04:38:08Z,final_summary_en,gpt-4.1-mini,4798,1127,5925
2025-09-11T04:39:11Z,category_summary,gpt-4.1-mini,126,21,147
2025-09-11T04:39:13Z,category_summary,gpt-4.1-mini,124,37,161
2025-09-11T04:39:16Z,category_summary,gpt-4.1-mini,118,25,143
2025-09-11T04:39:18Z,category_summary,gpt-4.1-mini,146,32,178
2025-09-11T04:39:20Z,category_summary,gpt-4.1-mini,134,43,177
2025-09-11T04:39:21Z,RUN_TOTAL,,247024,35740,282764
2025-09-12T04:24:19Z,pre_sentiment,gpt-4.1-mini,280,1,281
2025-09-12T04:24:20Z,pre_sentiment,gpt-4.1-mini,286,1,287
2025-09-12T04:24:20Z,pre_sentiment,gpt-4.1-mini,286,1,287
2025-09-12T04:24:20Z,pre_sentiment,gpt-4.1-mini,286,1,287
2025-09-12T04:24:21Z,pre_sentiment,gpt-4.1-mini,281,1,282
2025-09-12T04:24:23Z,sentiment,gpt-4.1-mini,1904,124,2028
2025-09-12T04:24:24Z,pre_sentiment,gpt-4.1-mini,283,1,284
2025-09-12T04:24:27Z,sentiment,gpt-4.1-mini,3374,179,3553
2025-09-12T04:24:27Z,pre_sentiment,gpt-4.1-mini,285,1,286
2025-09-12T04:24:31Z,sentiment,gpt-4.1-mini,1535,143,1678
2025-09-12T04:24:32Z,pre_sentiment,gpt-4.1-mini,284,1,285
2025-09-12T04:24:32Z,pre_sentiment,gpt-4.1-mini,279,1,280
2025-09-12T04:24:33Z,pre_sentiment,gpt-4.1-mini,282,1,283
2025-09-12T04:24:33Z,pre_sentiment,gpt-4.1-mini,289,1,290
2025-09-12T04:24:34Z,pre_sentiment,gpt-4.1-mini,278,1,279
2025-09-12T04:24:39Z,pre_sentiment,gpt-4.1-mini,282,1,283
2025-09-12T04:24:40Z,pre_sentiment,gpt-4.1-mini,295,1,296
2025-09-12T04:24:46Z,pre_sentiment,gpt-4.1-mini,283,1,284
2025-09-12T04:24:50Z,sentiment,gpt-4.1-mini,1943,188,2131
2025-09-12T04:24:55Z,pre_sentiment,gpt-4.1-mini,274,1,275
2025-09-12T04:24:55Z,pre_sentiment,gpt-4.1-mini,285,1,286
2025-09-12T04:24:57Z,sentiment,gpt-4.1-mini,1225,138,1363
2025-09-12T04:24:58Z,pre_sentiment,gpt-4.1-mini,287,1,288
2025-09-12T04:25:01Z,sentiment,gpt-4.1-mini,2045,198,2243
2025-09-12T04:25:02Z,pre_sentiment,gpt-4.1-mini,280,1,281
2025-09-12T04:25:05Z,sentiment,gpt-4.1-mini,2390,222,2612
2025-09-12T04:25:06Z,pre_sentiment,gpt-4.1-mini,278,1,279
2025-09-12T04:25:06Z,pre_sentiment,gpt-4.1-mini,281,1,282
2025-09-12T04:25:10Z,sentiment,gpt-4.1-mini,1501,188,1689
2025-09-12T04:25:10Z,pre_sentiment,gpt-4.1-mini,288,1,289
2025-09-12T04:25:13Z,sentiment,gpt-4.1-mini,2104,193,2297
2025-09-12T04:25:14Z,pre_sentiment,gpt-4.1-mini,288,1,289
2025-09-12T04:25:17Z,sentiment,gpt-4.1-mini,1574,209,1783
2025-09-12T04:25:36Z,pre_sentiment,gpt-4.1-mini,301,1,302
2025-09-12T04:25:38Z,sentiment,gpt-4.1-mini,915,87,1002
2025-09-12T04:25:38Z,pre_sentiment,gpt-4.1-mini,295,1,296
2025-09-12T04:25:40Z,sentiment,gpt-4.1-mini,990,144,1134
2025-09-12T04:25:41Z,pre_sentiment,gpt-4.1-mini,293,1,294
2025-09-12T04:25:43Z,sentiment,gpt-4.1-mini,1380,166,1546
2025-09-12T04:25:44Z,pre_sentiment,gpt-4.1-mini,294,1,295
2025-09-12T04:25:45Z,pre_sentiment,gpt-4.1-mini,292,1,293
2025-09-12T04:25:49Z,sentiment,gpt-4.1-mini,7398,239,7637
2025-09-12T04:25:49Z,pre_sentiment,gpt-4.1-mini,297,1,298
2025-09-12T04:25:53Z,sentiment,gpt-4.1-mini,1834,211,2045
2025-09-12T04:25:54Z,pre_sentiment,gpt-4.1-mini,301,1,302
2025-09-12T04:25:54Z,pre_sentiment,gpt-4.1-mini,298,1,299
2025-09-12T04:25:55Z,pre_sentiment,gpt-4.1-mini,298,1,299
2025-09-12T04:25:56Z,sentiment,gpt-4.1-mini,912,93,1005
2025-09-12T04:25:57Z,pre_sentiment,gpt-4.1-mini,309,1,310
2025-09-12T04:25:57Z,pre_sentiment,gpt-4.1-mini,303,1,304
2025-09-12T04:26:01Z,sentiment,gpt-4.1-mini,4600,180,4780
2025-09-12T04:26:01Z,pre_sentiment,gpt-4.1-mini,299,1,300
2025-09-12T04:26:04Z,sentiment,gpt-4.1-mini,1721,180,1901
2025-09-12T04:26:05Z,pre_sentiment,gpt-4.1-mini,298,1,299
2025-09-12T04:26:09Z,sentiment,gpt-4.1-mini,9514,210,9724
2025-09-12T04:26:22Z,pre_sentiment,gpt-4.1-mini,280,1,281
2025-09-12T04:26:25Z,sentiment,gpt-4.1-mini,1127,121,1248
2025-09-12T04:26:25Z,pre_sentiment,gpt-4.1-mini,285,1,286
2025-09-12T04:26:27Z,sentiment,gpt-4.1-mini,1299,140,1439
2025-09-12T04:26:27Z,pre_sentiment,gpt-4.1-mini,286,1,287
2025-09-12T04:26:31Z,sentiment,gpt-4.1-mini,1674,196,1870
2025-09-12T04:26:31Z,pre_sentiment,gpt-4.1-mini,279,1,280
2025-09-12T04:26:32Z,pre_sentiment,gpt-4.1-mini,277,1,278
2025-09-12T04:26:34Z,sentiment,gpt-4.1-mini,1135,132,1267
2025-09-12T04:26:34Z,pre_sentiment,gpt-4.1-mini,291,1,292
2025-09-12T04:26:38Z,sentiment,gpt-4.1-mini,2165,214,2379
2025-09-12T04:26:38Z,pre_sentiment,gpt-4.1-mini,285,1,286
2025-09-12T04:26:42Z,sentiment,gpt-4.1-mini,3308,226,3534
2025-09-12T04:26:42Z,pre_sentiment,gpt-4.1-mini,293,1,294
2025-09-12T04:26:45Z,sentiment,gpt-4.1-mini,2180,168,2348
2025-09-12T04:26:45Z,pre_sentiment,gpt-4.1-mini,280,1,281
2025-09-12T04:26:47Z,sentiment,gpt-4.1-mini,943,126,1069
2025-09-12T04:26:53Z,pre_sentiment,gpt-4.1-mini,283,1,284
2025-09-12T04:26:56Z,sentiment,gpt-4.1-mini,2172,146,2318
2025-09-12T04:27:01Z,pre_sentiment,gpt-4.1-mini,285,1,286
2025-09-12T04:27:04Z,sentiment,gpt-4.1-mini,1829,196,2025
2025-09-12T04:27:05Z,pre_sentiment,gpt-4.1-mini,291,1,292
2025-09-12T04:27:08Z,sentiment,gpt-4.1-mini,2788,193,2981
2025-09-12T04:27:08Z,pre_sentiment,gpt-4.1-mini,266,1,267
2025-09-12T04:27:11Z,sentiment,gpt-4.1-mini,2810,176,2986
2025-09-12T04:27:15Z,pre_sentiment,gpt-4.1-mini,276,1,277
2025-09-12T04:27:19Z,sentiment,gpt-4.1-mini,1773,227,2000
2025-09-12T04:27:19Z,pre_sentiment,gpt-4.1-mini,275,1,276
2025-09-12T04:27:20Z,pre_sentiment,gpt-4.1-mini,281,1,282
2025-09-12T04:27:22Z,sentiment,gpt-4.1-mini,2417,146,2563
2025-09-12T04:27:22Z,pre_sentiment,gpt-4.1-mini,279,1,280
2025-09-12T04:27:23Z,pre_sentiment,gpt-4.1-mini,271,1,272
2025-09-12T04:27:36Z,pre_sentiment,gpt-4.1-mini,286,1,287
2025-09-12T04:27:38Z,sentiment,gpt-4.1-mini,1266,160,1426
2025-09-12T04:27:39Z,pre_sentiment,gpt-4.1-mini,286,1,287
2025-09-12T04:27:42Z,sentiment,gpt-4.1-mini,1720,192,1912
2025-09-12T04:27:42Z,pre_sentiment,gpt-4.1-mini,281,1,282
2025-09-12T04:27:46Z,sentiment,gpt-4.1-mini,2397,192,2589
2025-09-12T04:27:46Z,pre_sentiment,gpt-4.1-mini,278,1,279
2025-09-12T04:27:49Z,sentiment,gpt-4.1-mini,1702,173,1875
2025-09-12T04:27:49Z,pre_sentiment,gpt-4.1-mini,282,1,283
2025-09-12T04:27:52Z,sentiment,gpt-4.1-mini,1847,211,2058
2025-09-12T04:28:25Z,pre_sentiment,gpt-4.1-mini,296,1,297
2025-09-12T04:28:28Z,sentiment,gpt-4.1-mini,1124,131,1255
2025-09-12T04:28:28Z,pre_sentiment,gpt-4.1-mini,287,1,288
2025-09-12T04:28:31Z,sentiment,gpt-4.1-mini,1105,159,1264
2025-09-12T04:28:31Z,pre_sentiment,gpt-4.1-mini,292,1,293
2025-09-12T04:28:35Z,sentiment,gpt-4.1-mini,1152,184,1336
2025-09-12T04:28:56Z,pre_sentiment,gpt-4.1-mini,284,1,285
2025-09-12T04:29:00Z,sentiment,gpt-4.1-mini,1782,126,1908
2025-09-12T04:29:00Z,pre_sentiment,gpt-4.1-mini,288,1,289
2025-09-12T04:29:04Z,sentiment,gpt-4.1-mini,1725,198,1923
2025-09-12T04:29:04Z,pre_sentiment,gpt-4.1-mini,291,1,292
2025-09-12T04:29:08Z,sentiment,gpt-4.1-mini,1751,228,1979
2025-09-12T04:29:08Z,pre_sentiment,gpt-4.1-mini,287,1,288
2025-09-12T04:29:12Z,sentiment,gpt-4.1-mini,1835,174,2009
2025-09-12T04:29:20Z,pre_sentiment,gpt-4.1-mini,287,1,288
2025-09-12T04:29:24Z,sentiment,gpt-4.1-mini,1446,170,1616
2025-09-12T04:29:24Z,pre_sentiment,gpt-4.1-mini,284,1,285
2025-09-12T04:29:25Z,pre_sentiment,gpt-4.1-mini,282,1,283
2025-09-12T04:29:25Z,pre_sentiment,gpt-4.1-mini,286,1,287
2025-09-12T04:29:29Z,sentiment,gpt-4.1-mini,1508,201,1709
2025-09-12T04:29:29Z,pre_sentiment,gpt-4.1-mini,272,1,273
2025-09-12T04:29:32Z,sentiment,gpt-4.1-mini,1353,182,1535
2025-09-12T04:29:44Z,pre_sentiment,gpt-4.1-mini,287,1,288
2025-09-12T04:29:47Z,sentiment,gpt-4.1-mini,1670,217,1887
2025-09-12T04:29:48Z,pre_sentiment,gpt-4.1-mini,291,1,292
2025-09-12T04:29:48Z,pre_sentiment,gpt-4.1-mini,292,1,293
2025-09-12T04:29:49Z,pre_sentiment,gpt-4.1-mini,283,1,284
2025-09-12T04:29:49Z,pre_sentiment,gpt-4.1-mini,286,1,287
2025-09-12T04:29:49Z,pre_sentiment,gpt-4.1-mini,292,1,293
2025-09-12T04:29:50Z,pre_sentiment,gpt-4.1-mini,285,1,286
2025-09-12T04:30:07Z,pre_sentiment,gpt-4.1-mini,288,1,289
2025-09-12T04:30:09Z,sentiment,gpt-4.1-mini,1613,133,1746
2025-09-12T04:30:09Z,pre_sentiment,gpt-4.1-mini,291,1,292
2025-09-12T04:30:10Z,pre_sentiment,gpt-4.1-mini,279,1,280
2025-09-12T04:30:10Z,pre_sentiment,gpt-4.1-mini,276,1,277
2025-09-12T04:30:10Z,pre_sentiment,gpt-4.1-mini,281,1,282
2025-09-12T04:30:25Z,pre_sentiment,gpt-4.1-mini,288,1,289
2025-09-12T04:30:29Z,sentiment,gpt-4.1-mini,1675,226,1901
2025-09-12T04:30:29Z,pre_sentiment,gpt-4.1-mini,294,1,295
2025-09-12T04:30:30Z,pre_sentiment,gpt-4.1-mini,289,1,290
2025-09-12T04:30:33Z,sentiment,gpt-4.1-mini,1424,203,1627
2025-09-12T04:30:33Z,pre_sentiment,gpt-4.1-mini,280,1,281
2025-09-12T04:30:36Z,sentiment,gpt-4.1-mini,1082,145,1227
2025-09-12T04:30:37Z,pre_sentiment,gpt-4.1-mini,284,1,285
2025-09-12T04:30:37Z,pre_sentiment,gpt-4.1-mini,280,1,281
2025-09-12T04:30:39Z,sentiment,gpt-4.1-mini,1143,161,1304
2025-09-12T04:30:40Z,pre_sentiment,gpt-4.1-mini,275,1,276
2025-09-12T04:30:43Z,sentiment,gpt-4.1-mini,1175,184,1359
2025-09-12T04:30:43Z,pre_sentiment,gpt-4.1-mini,286,1,287
2025-09-12T04:30:46Z,sentiment,gpt-4.1-mini,1103,146,1249
2025-09-12T04:30:46Z,pre_sentiment,gpt-4.1-mini,285,1,286
2025-09-12T04:30:47Z,pre_sentiment,gpt-4.1-mini,281,1,282
2025-09-12T04:30:51Z,sentiment,gpt-4.1-mini,1254,192,1446
2025-09-12T04:30:51Z,pre_sentiment,gpt-4.1-mini,284,1,285
2025-09-12T04:30:52Z,pre_sentiment,gpt-4.1-mini,282,1,283
2025-09-12T04:30:56Z,sentiment,gpt-4.1-mini,1632,203,1835
2025-09-12T04:31:05Z,pre_sentiment,gpt-4.1-mini,296,1,297
2025-09-12T04:31:08Z,sentiment,gpt-4.1-mini,4344,212,4556
2025-09-12T04:31:10Z,article_selection,gpt-4.1-mini,1071,12,1083
2025-09-12T04:31:10Z,article_selection,gpt-4.1-mini,1848,12,1860
2025-09-12T04:31:11Z,article_selection,gpt-4.1-mini,3487,12,3499
2025-09-12T04:31:11Z,article_selection,gpt-4.1-mini,1020,13,1033
2025-09-12T04:31:12Z,article_selection,gpt-4.1-mini,491,13,504
2025-09-12T04:31:13Z,article_selection,gpt-4.1-mini,759,16,775
2025-09-12T04:31:40Z,final_summary_en,gpt-4.1-mini,3065,1401,4466
2025-09-12T04:31:59Z,final_summary_en,gpt-4.1-mini,1850,1240,3090
2025-09-12T04:32:14Z,final_summary_en,gpt-4.1-mini,1341,1023,2364
2025-09-12T04:32:27Z,final_summary_en,gpt-4.1-mini,1585,1040,2625
2025-09-12T04:32:43Z,final_summary_en,gpt-4.1-mini,1546,1031,2577
2025-09-12T04:33:01Z,final_summary_en,gpt-4.1-mini,3108,1284,4392
2025-09-12T04:33:17Z,final_summary_en,gpt-4.1-mini,2162,1138,3300
2025-09-12T04:33:32Z,final_summary_en,gpt-4.1-mini,1490,1136,2626
2025-09-12T04:33:50Z,final_summary_en,gpt-4.1-mini,1925,1293,3218
2025-09-12T04:34:07Z,final_summary_en,gpt-4.1-mini,1569,1147,2716
2025-09-12T04:34:31Z,final_summary_en,gpt-4.1-mini,1521,1141,2662
2025-09-12T04:34:46Z,final_summary_en,gpt-4.1-mini,923,988,1911
2025-09-12T04:35:03Z,final_summary_en,gpt-4.1-mini,1424,1221,2645
2025-09-12T04:35:24Z,final_summary_en,gpt-4.1-mini,1269,1003,2272
2025-09-12T04:35:40Z,final_summary_en,gpt-4.1-mini,845,978,1823
2025-09-12T04:35:56Z,final_summary_en,gpt-4.1-mini,895,1067,1962
2025-09-12T04:36:15Z,final_summary_en,gpt-4.1-mini,7157,1185,8342
2025-09-12T04:36:30Z,final_summary_en,gpt-4.1-mini,1469,1119,2588
2025-09-12T04:36:47Z,final_summary_en,gpt-4.1-mini,1435,1269,2704
2025-09-12T04:37:06Z,final_summary_en,gpt-4.1-mini,1591,1237,2828
2025-09-12T04:37:24Z,final_summary_en,gpt-4.1-mini,4350,1156,5506
2025-09-12T04:37:40Z,final_summary_en,gpt-4.1-mini,2157,1147,3304
2025-09-12T04:37:55Z,final_summary_en,gpt-4.1-mini,1117,965,2082
2025-09-12T04:39:01Z,category_summary,gpt-4.1-mini,132,43,175
2025-09-12T04:39:03Z,category_summary,gpt-4.1-mini,128,35,163
2025-09-12T04:39:06Z,category_summary,gpt-4.1-mini,126,37,163
2025-09-12T04:39:08Z,category_summary,gpt-4.1-mini,145,28,173
2025-09-12T04:39:10Z,category_summary,gpt-4.1-mini,133,42,175
2025-09-12T04:39:12Z,category_summary,gpt-4.1-mini,110,31,141
2025-09-12T04:39:14Z,RUN_TOTAL,,200996,37001,237997
2025-09-13T04:23:28Z,pre_sentiment,gpt-4.1-mini,292,1,293
2025-09-13T04:23:29Z,pre_sentiment,gpt-4.1-mini,286,1,287
2025-09-13T04:23:29Z,pre_sentiment,gpt-4.1-mini,274,1,275
2025-09-13T04:23:30Z,pre_sentiment,gpt-4.1-mini,285,1,286
2025-09-13T04:23:30Z,pre_sentiment,gpt-4.1-mini,285,1,286
2025-09-13T04:23:33Z,sentiment,gpt-4.1-mini,2431,192,2623
2025-09-13T04:23:35Z,pre_sentiment,gpt-4.1-mini,287,1,288
2025-09-13T04:23:35Z,pre_sentiment,gpt-4.1-mini,294,1,295
2025-09-13T04:23:35Z,pre_sentiment,gpt-4.1-mini,282,1,283
2025-09-13T04:23:36Z,pre_sentiment,gpt-4.1-mini,283,1,284
2025-09-13T04:23:36Z,pre_sentiment,gpt-4.1-mini,279,1,280
2025-09-13T04:23:40Z,sentiment,gpt-4.1-mini,1510,197,1707
2025-09-13T04:23:40Z,pre_sentiment,gpt-4.1-mini,279,1,280
2025-09-13T04:23:40Z,pre_sentiment,gpt-4.1-mini,286,1,287
2025-09-13T04:23:41Z,pre_sentiment,gpt-4.1-mini,287,1,288
2025-09-13T04:23:41Z,pre_sentiment,gpt-4.1-mini,269,1,270
2025-09-13T04:23:53Z,pre_sentiment,gpt-4.1-mini,282,1,283
2025-09-13T04:23:54Z,pre_sentiment,gpt-4.1-mini,284,1,285
2025-09-13T04:23:57Z,sentiment,gpt-4.1-mini,1399,149,1548
2025-09-13T04:24:08Z,pre_sentiment,gpt-4.1-mini,276,1,277
2025-09-13T04:24:08Z,pre_sentiment,gpt-4.1-mini,282,1,283
2025-09-13T04:24:11Z,sentiment,gpt-4.1-mini,1205,193,1398
2025-09-13T04:24:11Z,pre_sentiment,gpt-4.1-mini,285,1,286
2025-09-13T04:24:14Z,sentiment,gpt-4.1-mini,1725,219,1944
2025-09-13T04:24:14Z,pre_sentiment,gpt-4.1-mini,287,1,288
2025-09-13T04:24:17Z,sentiment,gpt-4.1-mini,2539,192,2731
2025-09-13T04:24:18Z,pre_sentiment,gpt-4.1-mini,283,1,284
2025-09-13T04:24:21Z,sentiment,gpt-4.1-mini,1416,245,1661
2025-09-13T04:24:22Z,pre_sentiment,gpt-4.1-mini,281,1,282
2025-09-13T04:24:24Z,sentiment,gpt-4.1-mini,1583,161,1744
2025-09-13T04:24:24Z,pre_sentiment,gpt-4.1-mini,278,1,279
2025-09-13T04:24:27Z,sentiment,gpt-4.1-mini,1556,197,1753
2025-09-13T04:24:28Z,pre_sentiment,gpt-4.1-mini,281,1,282
2025-09-13T04:24:30Z,sentiment,gpt-4.1-mini,1696,164,1860
2025-09-13T04:24:31Z,pre_sentiment,gpt-4.1-mini,281,1,282
2025-09-13T04:24:34Z,sentiment,gpt-4.1-mini,1463,186,1649
2025-09-13T04:24:34Z,pre_sentiment,gpt-4.1-mini,291,1,292
2025-09-13T04:24:35Z,pre_sentiment,gpt-4.1-mini,284,1,285
2025-09-13T04:24:37Z,sentiment,gpt-4.1-mini,2138,182,2320
2025-09-13T04:24:38Z,pre_sentiment,gpt-4.1-mini,286,1,287
2025-09-13T04:24:41Z,sentiment,gpt-4.1-mini,3118,217,3335
2025-09-13T04:24:41Z,pre_sentiment,gpt-4.1-mini,280,1,281
2025-09-13T04:24:43Z,sentiment,gpt-4.1-mini,1410,151,1561
2025-09-13T04:25:05Z,pre_sentiment,gpt-4.1-mini,298,1,299
2025-09-13T04:25:06Z,sentiment,gpt-4.1-mini,917,91,1008
2025-09-13T04:25:07Z,pre_sentiment,gpt-4.1-mini,305,1,306
2025-09-13T04:25:09Z,sentiment,gpt-4.1-mini,1687,216,1903
2025-09-13T04:25:10Z,pre_sentiment,gpt-4.1-mini,302,1,303
2025-09-13T04:25:13Z,sentiment,gpt-4.1-mini,1733,190,1923
2025-09-13T04:25:14Z,pre_sentiment,gpt-4.1-mini,286,1,287
2025-09-13T04:25:15Z,sentiment,gpt-4.1-mini,1701,105,1806
2025-09-13T04:25:16Z,pre_sentiment,gpt-4.1-mini,301,1,302
2025-09-13T04:25:18Z,sentiment,gpt-4.1-mini,1658,189,1847
2025-09-13T04:25:19Z,pre_sentiment,gpt-4.1-mini,298,1,299
2025-09-13T04:25:19Z,pre_sentiment,gpt-4.1-mini,301,1,302
2025-09-13T04:25:20Z,sentiment,gpt-4.1-mini,915,84,999
2025-09-13T04:25:21Z,pre_sentiment,gpt-4.1-mini,295,1,296
2025-09-13T04:25:23Z,sentiment,gpt-4.1-mini,990,138,1128
2025-09-13T04:25:23Z,pre_sentiment,gpt-4.1-mini,298,1,299
2025-09-13T04:25:25Z,sentiment,gpt-4.1-mini,1655,188,1843
2025-09-13T04:25:26Z,pre_sentiment,gpt-4.1-mini,294,1,295
2025-09-13T04:25:26Z,pre_sentiment,gpt-4.1-mini,301,1,302
2025-09-13T04:25:28Z,sentiment,gpt-4.1-mini,920,104,1024
2025-09-13T04:25:43Z,pre_sentiment,gpt-4.1-mini,296,1,297
2025-09-13T04:25:45Z,sentiment,gpt-4.1-mini,1480,145,1625
2025-09-13T04:25:45Z,pre_sentiment,gpt-4.1-mini,282,1,283
2025-09-13T04:25:47Z,sentiment,gpt-4.1-mini,1113,134,1247
2025-09-13T04:25:48Z,pre_sentiment,gpt-4.1-mini,289,1,290
2025-09-13T04:25:50Z,sentiment,gpt-4.1-mini,2131,185,2316
2025-09-13T04:25:51Z,pre_sentiment,gpt-4.1-mini,282,1,283
2025-09-13T04:25:54Z,sentiment,gpt-4.1-mini,1612,241,1853
2025-09-13T04:25:54Z,pre_sentiment,gpt-4.1-mini,275,1,276
2025-09-13T04:25:57Z,sentiment,gpt-4.1-mini,1194,130,1324
2025-09-13T04:25:57Z,pre_sentiment,gpt-4.1-mini,282,1,283
2025-09-13T04:26:00Z,sentiment,gpt-4.1-mini,2213,253,2466
2025-09-13T04:26:00Z,pre_sentiment,gpt-4.1-mini,279,1,280
2025-09-13T04:26:05Z,sentiment,gpt-4.1-mini,2349,242,2591
2025-09-13T04:26:05Z,pre_sentiment,gpt-4.1-mini,277,1,278
2025-09-13T04:26:08Z,sentiment,gpt-4.1-mini,1900,155,2055
2025-09-13T04:26:08Z,pre_sentiment,gpt-4.1-mini,278,1,279
2025-09-13T04:26:10Z,sentiment,gpt-4.1-mini,1305,159,1464
2025-09-13T04:26:11Z,pre_sentiment,gpt-4.1-mini,274,1,275
2025-09-13T04:26:12Z,sentiment,gpt-4.1-mini,839,102,941
2025-09-13T04:26:19Z,pre_sentiment,gpt-4.1-mini,280,1,281
2025-09-13T04:26:20Z,sentiment,gpt-4.1-mini,919,120,1039
2025-09-13T04:26:32Z,pre_sentiment,gpt-4.1-mini,291,1,292
2025-09-13T04:26:35Z,sentiment,gpt-4.1-mini,2514,216,2730
2025-09-13T04:26:40Z,pre_sentiment,gpt-4.1-mini,272,1,273
2025-09-13T04:26:40Z,pre_sentiment,gpt-4.1-mini,276,1,277
2025-09-13T04:26:58Z,pre_sentiment,gpt-4.1-mini,292,1,293
2025-09-13T04:27:01Z,sentiment,gpt-4.1-mini,1428,202,1630
2025-09-13T04:27:01Z,pre_sentiment,gpt-4.1-mini,282,1,283
2025-09-13T04:27:03Z,sentiment,gpt-4.1-mini,1918,141,2059
2025-09-13T04:27:03Z,pre_sentiment,gpt-4.1-mini,282,1,283
2025-09-13T04:27:04Z,pre_sentiment,gpt-4.1-mini,283,1,284
2025-09-13T04:27:06Z,sentiment,gpt-4.1-mini,1335,147,1482
2025-09-13T04:27:17Z,pre_sentiment,gpt-4.1-mini,292,1,293
2025-09-13T04:27:19Z,sentiment,gpt-4.1-mini,1126,144,1270
2025-09-13T04:27:20Z,pre_sentiment,gpt-4.1-mini,292,1,293
2025-09-13T04:27:22Z,sentiment,gpt-4.1-mini,1086,124,1210
2025-09-13T04:27:32Z,pre_sentiment,gpt-4.1-mini,277,1,278
2025-09-13T04:27:34Z,sentiment,gpt-4.1-mini,1144,154,1298
2025-09-13T04:27:44Z,pre_sentiment,gpt-4.1-mini,295,1,296
2025-09-13T04:27:47Z,sentiment,gpt-4.1-mini,5855,192,6047
2025-09-13T04:27:47Z,pre_sentiment,gpt-4.1-mini,284,1,285
2025-09-13T04:27:49Z,sentiment,gpt-4.1-mini,1782,148,1930
2025-09-13T04:28:07Z,pre_sentiment,gpt-4.1-mini,288,1,289
2025-09-13T04:28:07Z,pre_sentiment,gpt-4.1-mini,292,1,293
2025-09-13T04:28:08Z,pre_sentiment,gpt-4.1-mini,286,1,287
2025-09-13T04:28:10Z,sentiment,gpt-4.1-mini,1311,179,1490
2025-09-13T04:28:11Z,pre_sentiment,gpt-4.1-mini,283,1,284
2025-09-13T04:28:11Z,pre_sentiment,gpt-4.1-mini,298,1,299
2025-09-13T04:28:11Z,pre_sentiment,gpt-4.1-mini,290,1,291
2025-09-13T04:28:12Z,pre_sentiment,gpt-4.1-mini,287,1,288
2025-09-13T04:28:15Z,sentiment,gpt-4.1-mini,1201,221,1422
2025-09-13T04:28:16Z,pre_sentiment,gpt-4.1-mini,292,1,293
2025-09-13T04:28:16Z,pre_sentiment,gpt-4.1-mini,285,1,286
2025-09-13T04:28:18Z,sentiment,gpt-4.1-mini,1356,164,1520
2025-09-13T04:28:18Z,pre_sentiment,gpt-4.1-mini,278,1,279
2025-09-13T04:28:19Z,pre_sentiment,gpt-4.1-mini,285,1,286
2025-09-13T04:28:34Z,pre_sentiment,gpt-4.1-mini,302,1,303
2025-09-13T04:28:34Z,pre_sentiment,gpt-4.1-mini,287,1,288
2025-09-13T04:28:34Z,pre_sentiment,gpt-4.1-mini,288,1,289
2025-09-13T04:28:37Z,sentiment,gpt-4.1-mini,1613,153,1766
2025-09-13T04:28:37Z,pre_sentiment,gpt-4.1-mini,291,1,292
2025-09-13T04:28:50Z,pre_sentiment,gpt-4.1-mini,283,1,284
2025-09-13T04:28:51Z,pre_sentiment,gpt-4.1-mini,291,1,292
2025-09-13T04:28:51Z,pre_sentiment,gpt-4.1-mini,289,1,290
2025-09-13T04:28:53Z,sentiment,gpt-4.1-mini,1299,142,1441
2025-09-13T04:28:54Z,pre_sentiment,gpt-4.1-mini,286,1,287
2025-09-13T04:28:54Z,pre_sentiment,gpt-4.1-mini,291,1,292
2025-09-13T04:28:56Z,sentiment,gpt-4.1-mini,1199,187,1386
2025-09-13T04:28:57Z,pre_sentiment,gpt-4.1-mini,299,1,300
2025-09-13T04:28:59Z,sentiment,gpt-4.1-mini,1495,207,1702
2025-09-13T04:29:00Z,pre_sentiment,gpt-4.1-mini,279,1,280
2025-09-13T04:29:00Z,pre_sentiment,gpt-4.1-mini,280,1,281
2025-09-13T04:29:03Z,sentiment,gpt-4.1-mini,1236,176,1412
2025-09-13T04:29:03Z,pre_sentiment,gpt-4.1-mini,278,1,279
2025-09-13T04:29:03Z,pre_sentiment,gpt-4.1-mini,280,1,281
2025-09-13T04:29:04Z,pre_sentiment,gpt-4.1-mini,287,1,288
2025-09-13T04:29:04Z,pre_sentiment,gpt-4.1-mini,284,1,285
2025-09-13T04:29:04Z,pre_sentiment,gpt-4.1-mini,295,1,296
2025-09-13T04:29:07Z,sentiment,gpt-4.1-mini,1210,193,1403
2025-09-13T04:29:15Z,article_selection,gpt-4.1-mini,648,9,657
2025-09-13T04:29:16Z,article_selection,gpt-4.1-mini,1327,12,1339
2025-09-13T04:29:16Z,article_selection,gpt-4.1-mini,862,9,871
2025-09-13T04:29:17Z,article_selection,gpt-4.1-mini,1095,16,1111
2025-09-13T04:29:17Z,article_selection,gpt-4.1-mini,604,9,613
2025-09-13T04:29:17Z,article_selection,gpt-4.1-mini,516,9,525
2025-09-13T04:29:33Z,final_summary_en,gpt-4.1-mini,1170,1192,2362
2025-09-13T04:29:48Z,final_summary_en,gpt-4.1-mini,1200,974,2174
2025-09-13T04:30:04Z,final_summary_en,gpt-4.1-mini,5610,1105,6715
2025-09-13T04:30:22Z,final_summary_en,gpt-4.1-mini,1306,1186,2492
2025-09-13T04:30:39Z,final_summary_en,gpt-4.1-mini,1997,1265,3262
2025-09-13T04:30:58Z,final_summary_en,gpt-4.1-mini,1447,1111,2558
2025-09-13T04:31:19Z,final_summary_en,gpt-4.1-mini,1429,1033,2462
2025-09-13T04:31:43Z,final_summary_en,gpt-4.1-mini,2878,1356,4234
2025-09-13T04:32:10Z,final_summary_en,gpt-4.1-mini,2121,1259,3380
2025-09-13T04:32:29Z,final_summary_en,gpt-4.1-mini,1472,1215,2687
2025-09-13T04:32:49Z,final_summary_en,gpt-4.1-mini,2290,1200,3490
2025-09-13T04:33:00Z,final_summary_en,gpt-4.1-mini,1881,912,2793
2025-09-13T04:33:18Z,final_summary_en,gpt-4.1-mini,1418,985,2403
2025-09-13T04:33:34Z,final_summary_en,gpt-4.1-mini,2275,1085,3360
2025-09-13T04:33:45Z,final_summary_en,gpt-4.1-mini,1185,988,2173
2025-09-13T04:33:58Z,final_summary_en,gpt-4.1-mini,1264,1122,2386
2025-09-13T04:34:13Z,final_summary_en,gpt-4.1-mini,967,1318,2285
2025-09-13T04:34:26Z,final_summary_en,gpt-4.1-mini,973,1124,2097
2025-09-13T04:34:40Z,final_summary_en,gpt-4.1-mini,1404,1100,2504
2025-09-13T04:34:54Z,final_summary_en,gpt-4.1-mini,973,1146,2119
2025-09-13T04:35:06Z,final_summary_en,gpt-4.1-mini,954,1054,2008
2025-09-13T04:36:19Z,category_summary,gpt-4.1-mini,98,24,122
2025-09-13T04:36:21Z,category_summary,gpt-4.1-mini,135,39,174
2025-09-13T04:36:23Z,category_summary,gpt-4.1-mini,132,29,161
2025-09-13T04:36:25Z,category_summary,gpt-4.1-mini,124,46,170
2025-09-13T04:36:28Z,category_summary,gpt-4.1-mini,134,36,170
2025-09-13T04:36:30Z,category_summary,gpt-4.1-mini,127,43,170
2025-09-13T04:36:31Z,RUN_TOTAL,,152598,33008,185606
2025-09-14T04:23:47Z,pre_sentiment,gpt-4.1-mini,283,1,284
2025-09-14T04:23:48Z,pre_sentiment,gpt-4.1-mini,284,1,285
2025-09-14T04:23:48Z,pre_sentiment,gpt-4.1-mini,288,1,289
2025-09-14T04:23:49Z,pre_sentiment,gpt-4.1-mini,284,1,285
2025-09-14T04:23:50Z,pre_sentiment,gpt-4.1-mini,280,1,281
2025-09-14T04:23:57Z,sentiment,gpt-4.1-mini,1303,150,1453
2025-09-14T04:23:58Z,pre_sentiment,gpt-4.1-mini,282,1,283
2025-09-14T04:23:58Z,pre_sentiment,gpt-4.1-mini,286,1,287
2025-09-14T04:24:01Z,sentiment,gpt-4.1-mini,2318,164,2482
2025-09-14T04:24:02Z,pre_sentiment,gpt-4.1-mini,283,1,284
2025-09-14T04:24:02Z,pre_sentiment,gpt-4.1-mini,283,1,284
2025-09-14T04:24:02Z,pre_sentiment,gpt-4.1-mini,282,1,283
2025-09-14T04:24:02Z,pre_sentiment,gpt-4.1-mini,289,1,290
2025-09-14T04:24:03Z,pre_sentiment,gpt-4.1-mini,288,1,289
2025-09-14T04:24:07Z,pre_sentiment,gpt-4.1-mini,279,1,280
2025-09-14T04:24:07Z,pre_sentiment,gpt-4.1-mini,290,1,291
2025-09-14T04:24:08Z,pre_sentiment,gpt-4.1-mini,285,1,286
2025-09-14T04:24:26Z,pre_sentiment,gpt-4.1-mini,276,1,277
2025-09-14T04:24:26Z,pre_sentiment,gpt-4.1-mini,280,1,281
2025-09-14T04:24:29Z,sentiment,gpt-4.1-mini,1700,194,1894
2025-09-14T04:24:29Z,pre_sentiment,gpt-4.1-mini,280,1,281
2025-09-14T04:24:31Z,sentiment,gpt-4.1-mini,1319,150,1469
2025-09-14T04:24:32Z,pre_sentiment,gpt-4.1-mini,282,1,283
2025-09-14T04:24:34Z,sentiment,gpt-4.1-mini,1205,193,1398
2025-09-14T04:24:52Z,pre_sentiment,gpt-4.1-mini,298,1,299
2025-09-14T04:24:53Z,sentiment,gpt-4.1-mini,917,89,1006
2025-09-14T04:24:54Z,pre_sentiment,gpt-4.1-mini,302,1,303
2025-09-14T04:24:57Z,sentiment,gpt-4.1-mini,1733,197,1930
2025-09-14T04:24:57Z,pre_sentiment,gpt-4.1-mini,286,1,287
2025-09-14T04:24:59Z,sentiment,gpt-4.1-mini,1701,138,1839
2025-09-14T04:24:59Z,pre_sentiment,gpt-4.1-mini,298,1,299
2025-09-14T04:24:59Z,pre_sentiment,gpt-4.1-mini,301,1,302
2025-09-14T04:25:01Z,sentiment,gpt-4.1-mini,915,88,1003
2025-09-14T04:25:01Z,pre_sentiment,gpt-4.1-mini,295,1,296
2025-09-14T04:25:03Z,sentiment,gpt-4.1-mini,990,154,1144
2025-09-14T04:25:04Z,pre_sentiment,gpt-4.1-mini,294,1,295
2025-09-14T04:25:04Z,pre_sentiment,gpt-4.1-mini,301,1,302
2025-09-14T04:25:41Z,pre_sentiment,gpt-4.1-mini,262,1,263
2025-09-14T04:25:43Z,sentiment,gpt-4.1-mini,2077,214,2291
2025-09-14T04:25:57Z,pre_sentiment,gpt-4.1-mini,281,1,282
2025-09-14T04:26:16Z,pre_sentiment,gpt-4.1-mini,281,1,282
2025-09-14T04:26:42Z,pre_sentiment,gpt-4.1-mini,286,1,287
2025-09-14T04:26:53Z,pre_sentiment,gpt-4.1-mini,283,1,284
2025-09-14T04:26:53Z,pre_sentiment,gpt-4.1-mini,291,1,292
2025-09-14T04:26:53Z,pre_sentiment,gpt-4.1-mini,282,1,283
2025-09-14T04:26:53Z,pre_sentiment,gpt-4.1-mini,302,1,303
2025-09-14T04:27:11Z,article_selection,gpt-4.1-mini,726,12,738
2025-09-14T04:27:30Z,final_summary_en,gpt-4.1-mini,1460,1139,2599
2025-09-14T04:27:46Z,final_summary_en,gpt-4.1-mini,957,1117,2074
2025-09-14T04:27:56Z,final_summary_en,gpt-4.1-mini,1039,871,1910
2025-09-14T04:28:08Z,final_summary_en,gpt-4.1-mini,718,882,1600
2025-09-14T04:28:25Z,final_summary_en,gpt-4.1-mini,1487,1320,2807
2025-09-14T04:28:45Z,final_summary_en,gpt-4.1-mini,1821,1144,2965
2025-09-14T04:28:59Z,final_summary_en,gpt-4.1-mini,1027,978,2005
2025-09-14T04:29:27Z,category_summary,gpt-4.1-mini,84,27,111
2025-09-14T04:29:28Z,category_summary,gpt-4.1-mini,84,20,104
2025-09-14T04:29:30Z,category_summary,gpt-4.1-mini,120,29,149
2025-09-14T04:29:31Z,category_summary,gpt-4.1-mini,90,20,110
2025-09-14T04:29:32Z,RUN_TOTAL,,35818,9325,45143
2025-09-15T04:26:07Z,pre_sentiment,gpt-4.1-mini,280,1,281
2025-09-15T04:26:08Z,pre_sentiment,gpt-4.1-mini,281,1,282
2025-09-15T04:26:09Z,pre_sentiment,gpt-4.1-mini,288,1,289
2025-09-15T04:26:10Z,pre_sentiment,gpt-4.1-mini,285,1,286
2025-09-15T04:26:10Z,pre_sentiment,gpt-4.1-mini,284,1,285
2025-09-15T04:26:11Z,pre_sentiment,gpt-4.1-mini,281,1,282
2025-09-15T04:26:12Z,pre_sentiment,gpt-4.1-mini,293,1,294
2025-09-15T04:26:12Z,pre_sentiment,gpt-4.1-mini,281,1,282
2025-09-15T04:26:15Z,sentiment,gpt-4.1-mini,1725,135,1860
2025-09-15T04:26:15Z,pre_sentiment,gpt-4.1-mini,284,1,285
2025-09-15T04:26:18Z,sentiment,gpt-4.1-mini,1362,211,1573
2025-09-15T04:26:19Z,pre_sentiment,gpt-4.1-mini,283,1,284
2025-09-15T04:26:19Z,pre_sentiment,gpt-4.1-mini,282,1,283
2025-09-15T04:26:22Z,sentiment,gpt-4.1-mini,1406,141,1547
2025-09-15T04:26:23Z,pre_sentiment,gpt-4.1-mini,278,1,279
2025-09-15T04:26:25Z,sentiment,gpt-4.1-mini,905,86,991
2025-09-15T04:26:25Z,pre_sentiment,gpt-4.1-mini,285,1,286
2025-09-15T04:26:26Z,pre_sentiment,gpt-4.1-mini,291,1,292
2025-09-15T04:26:28Z,sentiment,gpt-4.1-mini,1318,138,1456
2025-09-15T04:26:39Z,pre_sentiment,gpt-4.1-mini,284,1,285
2025-09-15T04:26:43Z,sentiment,gpt-4.1-mini,1362,235,1597
2025-09-15T04:26:48Z,pre_sentiment,gpt-4.1-mini,279,1,280
2025-09-15T04:26:48Z,pre_sentiment,gpt-4.1-mini,282,1,283
2025-09-15T04:26:51Z,sentiment,gpt-4.1-mini,2036,194,2230
2025-09-15T04:26:52Z,pre_sentiment,gpt-4.1-mini,278,1,279
2025-09-15T04:26:54Z,sentiment,gpt-4.1-mini,1835,177,2012
2025-09-15T04:26:55Z,pre_sentiment,gpt-4.1-mini,284,1,285
2025-09-15T04:26:58Z,sentiment,gpt-4.1-mini,1614,227,1841
2025-09-15T04:26:58Z,pre_sentiment,gpt-4.1-mini,295,1,296
2025-09-15T04:27:02Z,sentiment,gpt-4.1-mini,1424,204,1628
2025-09-15T04:27:02Z,pre_sentiment,gpt-4.1-mini,280,1,281
2025-09-15T04:27:07Z,sentiment,gpt-4.1-mini,1618,207,1825
2025-09-15T04:27:08Z,pre_sentiment,gpt-4.1-mini,287,1,288
2025-09-15T04:27:11Z,sentiment,gpt-4.1-mini,1520,185,1705
2025-09-15T04:27:11Z,pre_sentiment,gpt-4.1-mini,285,1,286
2025-09-15T04:27:14Z,sentiment,gpt-4.1-mini,1690,205,1895
2025-09-15T04:27:15Z,pre_sentiment,gpt-4.1-mini,285,1,286
2025-09-15T04:27:18Z,sentiment,gpt-4.1-mini,2300,194,2494
2025-09-15T04:27:18Z,pre_sentiment,gpt-4.1-mini,288,1,289
2025-09-15T04:27:19Z,pre_sentiment,gpt-4.1-mini,284,1,285
2025-09-15T04:27:21Z,sentiment,gpt-4.1-mini,1924,181,2105
2025-09-15T04:27:22Z,pre_sentiment,gpt-4.1-mini,280,1,281
2025-09-15T04:27:40Z,pre_sentiment,gpt-4.1-mini,298,1,299
2025-09-15T04:27:42Z,sentiment,gpt-4.1-mini,917,99,1016
2025-09-15T04:27:42Z,pre_sentiment,gpt-4.1-mini,286,1,287
2025-09-15T04:27:44Z,sentiment,gpt-4.1-mini,1701,106,1807
2025-09-15T04:27:44Z,pre_sentiment,gpt-4.1-mini,298,1,299
2025-09-15T04:27:45Z,pre_sentiment,gpt-4.1-mini,301,1,302
2025-09-15T04:27:47Z,sentiment,gpt-4.1-mini,915,87,1002
2025-09-15T04:27:47Z,pre_sentiment,gpt-4.1-mini,294,1,295
2025-09-15T04:27:47Z,pre_sentiment,gpt-4.1-mini,301,1,302
2025-09-15T04:28:03Z,pre_sentiment,gpt-4.1-mini,285,1,286
2025-09-15T04:28:05Z,sentiment,gpt-4.1-mini,1686,137,1823
2025-09-15T04:28:06Z,pre_sentiment,gpt-4.1-mini,283,1,284
2025-09-15T04:28:08Z,sentiment,gpt-4.1-mini,1482,162,1644
2025-09-15T04:28:19Z,pre_sentiment,gpt-4.1-mini,268,1,269
2025-09-15T04:28:24Z,pre_sentiment,gpt-4.1-mini,277,1,278
2025-09-15T04:28:24Z,pre_sentiment,gpt-4.1-mini,279,1,280
2025-09-15T04:28:24Z,pre_sentiment,gpt-4.1-mini,275,1,276
2025-09-15T04:28:25Z,pre_sentiment,gpt-4.1-mini,275,1,276
2025-09-15T04:28:43Z,pre_sentiment,gpt-4.1-mini,284,1,285
2025-09-15T04:28:46Z,sentiment,gpt-4.1-mini,1871,217,2088
2025-09-15T04:29:45Z,pre_sentiment,gpt-4.1-mini,291,1,292
2025-09-15T04:29:47Z,sentiment,gpt-4.1-mini,1667,142,1809
2025-09-15T04:29:47Z,pre_sentiment,gpt-4.1-mini,293,1,294
2025-09-15T04:29:51Z,sentiment,gpt-4.1-mini,1750,222,1972
2025-09-15T04:30:28Z,pre_sentiment,gpt-4.1-mini,279,1,280
2025-09-15T04:30:29Z,pre_sentiment,gpt-4.1-mini,284,1,285
2025-09-15T04:30:33Z,sentiment,gpt-4.1-mini,2126,222,2348
2025-09-15T04:30:33Z,pre_sentiment,gpt-4.1-mini,283,1,284
2025-09-15T04:30:57Z,article_selection,gpt-4.1-mini,849,12,861
2025-09-15T04:30:58Z,article_selection,gpt-4.1-mini,603,6,609
2025-09-15T04:30:58Z,article_selection,gpt-4.1-mini,386,6,392
2025-09-15T04:30:58Z,article_selection,gpt-4.1-mini,516,5,521
2025-09-15T04:31:08Z,final_summary_en,gpt-4.1-mini,1381,953,2334
2025-09-15T04:31:18Z,final_summary_en,gpt-4.1-mini,1659,1036,2695
2025-09-15T04:31:33Z,final_summary_en,gpt-4.1-mini,1782,1156,2938
2025-09-15T04:31:48Z,final_summary_en,gpt-4.1-mini,1183,1261,2444
2025-09-15T04:32:00Z,final_summary_en,gpt-4.1-mini,1380,1069,2449
2025-09-15T04:32:17Z,final_summary_en,gpt-4.1-mini,1258,1267,2525
2025-09-15T04:32:29Z,final_summary_en,gpt-4.1-mini,1101,1130,2231
2025-09-15T04:32:41Z,final_summary_en,gpt-4.1-mini,1903,1183,3086
2025-09-15T04:32:56Z,final_summary_en,gpt-4.1-mini,1442,1067,2509
2025-09-15T04:33:09Z,final_summary_en,gpt-4.1-mini,2047,1191,3238
2025-09-15T04:33:19Z,final_summary_en,gpt-4.1-mini,1520,923,2443
2025-09-15T04:33:56Z,category_summary,gpt-4.1-mini,136,33,169
2025-09-15T04:33:58Z,category_summary,gpt-4.1-mini,100,32,132
2025-09-15T04:34:00Z,category_summary,gpt-4.1-mini,100,30,130
2025-09-15T04:34:02Z,category_summary,gpt-4.1-mini,90,21,111
2025-09-15T04:34:04Z,category_summary,gpt-4.1-mini,101,37,138
2025-09-15T04:34:06Z,RUN_TOTAL,,70792,16578,87370
2025-09-16T04:24:28Z,pre_sentiment,gpt-4.1-mini,285,1,286
2025-09-16T04:24:29Z,pre_sentiment,gpt-4.1-mini,286,1,287
2025-09-16T04:24:33Z,sentiment,gpt-4.1-mini,1677,219,1896
2025-09-16T04:24:34Z,pre_sentiment,gpt-4.1-mini,283,1,284
2025-09-16T04:24:34Z,pre_sentiment,gpt-4.1-mini,281,1,282
2025-09-16T04:24:35Z,pre_sentiment,gpt-4.1-mini,277,1,278
2025-09-16T04:24:39Z,sentiment,gpt-4.1-mini,1449,223,1672
2025-09-16T04:24:40Z,pre_sentiment,gpt-4.1-mini,283,1,284
2025-09-16T04:24:43Z,sentiment,gpt-4.1-mini,2537,179,2716
2025-09-16T04:24:44Z,pre_sentiment,gpt-4.1-mini,283,1,284
2025-09-16T04:24:44Z,pre_sentiment,gpt-4.1-mini,285,1,286
2025-09-16T04:24:46Z,sentiment,gpt-4.1-mini,1527,143,1670
2025-09-16T04:24:47Z,pre_sentiment,gpt-4.1-mini,283,1,284
2025-09-16T04:24:47Z,pre_sentiment,gpt-4.1-mini,283,1,284
2025-09-16T04:24:48Z,pre_sentiment,gpt-4.1-mini,287,1,288
2025-09-16T04:24:48Z,pre_sentiment,gpt-4.1-mini,283,1,284
2025-09-16T04:24:51Z,sentiment,gpt-4.1-mini,2165,198,2363
2025-09-16T04:24:52Z,pre_sentiment,gpt-4.1-mini,290,1,291
2025-09-16T04:24:54Z,sentiment,gpt-4.1-mini,1598,152,1750
2025-09-16T04:24:55Z,pre_sentiment,gpt-4.1-mini,289,1,290
2025-09-16T04:25:04Z,pre_sentiment,gpt-4.1-mini,287,1,288
2025-09-16T04:25:04Z,pre_sentiment,gpt-4.1-mini,279,1,280
2025-09-16T04:25:05Z,pre_sentiment,gpt-4.1-mini,285,1,286
2025-09-16T04:25:07Z,sentiment,gpt-4.1-mini,1504,143,1647
2025-09-16T04:25:20Z,pre_sentiment,gpt-4.1-mini,279,1,280
2025-09-16T04:25:24Z,sentiment,gpt-4.1-mini,2542,244,2786
2025-09-16T04:25:24Z,pre_sentiment,gpt-4.1-mini,288,1,289
2025-09-16T04:25:26Z,sentiment,gpt-4.1-mini,1653,183,1836
2025-09-16T04:25:27Z,pre_sentiment,gpt-4.1-mini,284,1,285
2025-09-16T04:25:29Z,sentiment,gpt-4.1-mini,1225,177,1402
2025-09-16T04:25:30Z,pre_sentiment,gpt-4.1-mini,284,1,285
2025-09-16T04:25:33Z,sentiment,gpt-4.1-mini,1994,230,2224
2025-09-16T04:25:33Z,pre_sentiment,gpt-4.1-mini,277,1,278
2025-09-16T04:25:35Z,sentiment,gpt-4.1-mini,1279,147,1426
2025-09-16T04:25:36Z,pre_sentiment,gpt-4.1-mini,281,1,282
2025-09-16T04:25:38Z,sentiment,gpt-4.1-mini,1386,205,1591
2025-09-16T04:25:39Z,pre_sentiment,gpt-4.1-mini,285,1,286
2025-09-16T04:25:42Z,sentiment,gpt-4.1-mini,2363,224,2587
2025-09-16T04:25:42Z,pre_sentiment,gpt-4.1-mini,281,1,282
2025-09-16T04:25:46Z,sentiment,gpt-4.1-mini,2209,244,2453
2025-09-16T04:25:46Z,pre_sentiment,gpt-4.1-mini,285,1,286
2025-09-16T04:25:47Z,pre_sentiment,gpt-4.1-mini,279,1,280
2025-09-16T04:26:01Z,pre_sentiment,gpt-4.1-mini,295,1,296
2025-09-16T04:26:03Z,sentiment,gpt-4.1-mini,1006,93,1099
2025-09-16T04:26:04Z,pre_sentiment,gpt-4.1-mini,296,1,297
2025-09-16T04:26:07Z,sentiment,gpt-4.1-mini,1120,212,1332
2025-09-16T04:26:08Z,pre_sentiment,gpt-4.1-mini,299,1,300
2025-09-16T04:26:10Z,sentiment,gpt-4.1-mini,1113,145,1258
2025-09-16T04:26:11Z,pre_sentiment,gpt-4.1-mini,300,1,301
2025-09-16T04:26:13Z,sentiment,gpt-4.1-mini,923,128,1051
2025-09-16T04:26:13Z,pre_sentiment,gpt-4.1-mini,296,1,297
2025-09-16T04:26:16Z,sentiment,gpt-4.1-mini,1541,176,1717
2025-09-16T04:26:17Z,pre_sentiment,gpt-4.1-mini,299,1,300
2025-09-16T04:26:17Z,pre_sentiment,gpt-4.1-mini,297,1,298
2025-09-16T04:26:20Z,sentiment,gpt-4.1-mini,1661,152,1813
2025-09-16T04:26:20Z,pre_sentiment,gpt-4.1-mini,298,1,299
2025-09-16T04:26:20Z,pre_sentiment,gpt-4.1-mini,297,1,298
2025-09-16T04:26:22Z,sentiment,gpt-4.1-mini,1704,119,1823
2025-09-16T04:26:22Z,pre_sentiment,gpt-4.1-mini,299,1,300
2025-09-16T04:26:25Z,sentiment,gpt-4.1-mini,2842,208,3050
2025-09-16T04:26:25Z,pre_sentiment,gpt-4.1-mini,300,1,301
2025-09-16T04:26:28Z,sentiment,gpt-4.1-mini,3186,194,3380
2025-09-16T04:26:29Z,pre_sentiment,gpt-4.1-mini,295,1,296
2025-09-16T04:26:32Z,sentiment,gpt-4.1-mini,4084,214,4298
2025-09-16T04:26:32Z,pre_sentiment,gpt-4.1-mini,298,1,299
2025-09-16T04:26:34Z,sentiment,gpt-4.1-mini,917,89,1006
2025-09-16T04:26:34Z,pre_sentiment,gpt-4.1-mini,298,1,299
2025-09-16T04:26:36Z,sentiment,gpt-4.1-mini,1685,175,1860
2025-09-16T04:26:45Z,pre_sentiment,gpt-4.1-mini,284,1,285
2025-09-16T04:26:53Z,pre_sentiment,gpt-4.1-mini,278,1,279
2025-09-16T04:26:56Z,sentiment,gpt-4.1-mini,2544,176,2720
2025-09-16T04:26:56Z,pre_sentiment,gpt-4.1-mini,277,1,278
2025-09-16T04:26:58Z,sentiment,gpt-4.1-mini,1201,133,1334
2025-09-16T04:26:59Z,pre_sentiment,gpt-4.1-mini,284,1,285
2025-09-16T04:27:00Z,sentiment,gpt-4.1-mini,1868,129,1997
2025-09-16T04:27:01Z,pre_sentiment,gpt-4.1-mini,285,1,286
2025-09-16T04:27:07Z,sentiment,gpt-4.1-mini,2059,238,2297
2025-09-16T04:27:07Z,pre_sentiment,gpt-4.1-mini,289,1,290
2025-09-16T04:27:09Z,sentiment,gpt-4.1-mini,1518,142,1660
2025-09-16T04:27:10Z,pre_sentiment,gpt-4.1-mini,282,1,283
2025-09-16T04:27:12Z,sentiment,gpt-4.1-mini,1003,153,1156
2025-09-16T04:27:12Z,pre_sentiment,gpt-4.1-mini,284,1,285
2025-09-16T04:27:16Z,sentiment,gpt-4.1-mini,2124,213,2337
2025-09-16T04:27:16Z,pre_sentiment,gpt-4.1-mini,283,1,284
2025-09-16T04:27:18Z,sentiment,gpt-4.1-mini,1532,149,1681
2025-09-16T04:27:23Z,pre_sentiment,gpt-4.1-mini,291,1,292
2025-09-16T04:27:26Z,sentiment,gpt-4.1-mini,1326,229,1555
2025-09-16T04:27:27Z,pre_sentiment,gpt-4.1-mini,290,1,291
2025-09-16T04:27:29Z,sentiment,gpt-4.1-mini,2008,151,2159
2025-09-16T04:27:46Z,pre_sentiment,gpt-4.1-mini,267,1,268
2025-09-16T04:27:46Z,pre_sentiment,gpt-4.1-mini,270,1,271
2025-09-16T04:27:50Z,sentiment,gpt-4.1-mini,1804,187,1991
2025-09-16T04:27:50Z,pre_sentiment,gpt-4.1-mini,294,1,295
2025-09-16T04:27:53Z,sentiment,gpt-4.1-mini,2392,230,2622
2025-09-16T04:27:58Z,pre_sentiment,gpt-4.1-mini,272,1,273
2025-09-16T04:27:58Z,pre_sentiment,gpt-4.1-mini,274,1,275
2025-09-16T04:27:59Z,pre_sentiment,gpt-4.1-mini,280,1,281
2025-09-16T04:27:59Z,pre_sentiment,gpt-4.1-mini,276,1,277
2025-09-16T04:27:59Z,pre_sentiment,gpt-4.1-mini,276,1,277
2025-09-16T04:28:03Z,sentiment,gpt-4.1-mini,3312,228,3540
2025-09-16T04:28:03Z,pre_sentiment,gpt-4.1-mini,276,1,277
2025-09-16T04:28:04Z,pre_sentiment,gpt-4.1-mini,279,1,280
2025-09-16T04:28:04Z,pre_sentiment,gpt-4.1-mini,275,1,276
2025-09-16T04:28:04Z,pre_sentiment,gpt-4.1-mini,275,1,276
2025-09-16T04:28:08Z,pre_sentiment,gpt-4.1-mini,286,1,287
2025-09-16T04:28:11Z,sentiment,gpt-4.1-mini,1790,209,1999
2025-09-16T04:28:11Z,pre_sentiment,gpt-4.1-mini,285,1,286
2025-09-16T04:28:11Z,pre_sentiment,gpt-4.1-mini,286,1,287
2025-09-16T04:28:13Z,sentiment,gpt-4.1-mini,1427,142,1569
2025-09-16T04:28:14Z,pre_sentiment,gpt-4.1-mini,292,1,293
2025-09-16T04:28:17Z,sentiment,gpt-4.1-mini,2671,204,2875
2025-09-16T04:28:17Z,pre_sentiment,gpt-4.1-mini,288,1,289
2025-09-16T04:28:20Z,sentiment,gpt-4.1-mini,1800,213,2013
2025-09-16T04:28:21Z,pre_sentiment,gpt-4.1-mini,284,1,285
2025-09-16T04:28:24Z,sentiment,gpt-4.1-mini,1639,215,1854
2025-09-16T04:28:24Z,pre_sentiment,gpt-4.1-mini,280,1,281
2025-09-16T04:28:26Z,sentiment,gpt-4.1-mini,1770,171,1941
2025-09-16T04:28:36Z,pre_sentiment,gpt-4.1-mini,284,1,285
2025-09-16T04:28:39Z,sentiment,gpt-4.1-mini,1421,180,1601
2025-09-16T04:28:39Z,pre_sentiment,gpt-4.1-mini,286,1,287
2025-09-16T04:28:44Z,sentiment,gpt-4.1-mini,1093,176,1269
2025-09-16T04:28:54Z,pre_sentiment,gpt-4.1-mini,291,1,292
2025-09-16T04:28:56Z,sentiment,gpt-4.1-mini,1118,131,1249
2025-09-16T04:28:56Z,pre_sentiment,gpt-4.1-mini,287,1,288
2025-09-16T04:28:58Z,sentiment,gpt-4.1-mini,1181,173,1354
2025-09-16T04:29:20Z,pre_sentiment,gpt-4.1-mini,287,1,288
2025-09-16T04:29:22Z,sentiment,gpt-4.1-mini,1724,159,1883
2025-09-16T04:29:22Z,pre_sentiment,gpt-4.1-mini,292,1,293
2025-09-16T04:29:27Z,sentiment,gpt-4.1-mini,1527,196,1723
2025-09-16T04:29:27Z,pre_sentiment,gpt-4.1-mini,291,1,292
2025-09-16T04:29:29Z,sentiment,gpt-4.1-mini,1667,145,1812
2025-09-16T04:29:37Z,pre_sentiment,gpt-4.1-mini,285,1,286
2025-09-16T04:29:40Z,sentiment,gpt-4.1-mini,1181,140,1321
2025-09-16T04:29:46Z,pre_sentiment,gpt-4.1-mini,290,1,291
2025-09-16T04:29:49Z,sentiment,gpt-4.1-mini,1903,234,2137
2025-09-16T04:29:49Z,pre_sentiment,gpt-4.1-mini,291,1,292
2025-09-16T04:29:50Z,pre_sentiment,gpt-4.1-mini,281,1,282
2025-09-16T04:29:51Z,pre_sentiment,gpt-4.1-mini,279,1,280
2025-09-16T04:29:51Z,pre_sentiment,gpt-4.1-mini,290,1,291
2025-09-16T04:29:51Z,pre_sentiment,gpt-4.1-mini,286,1,287
2025-09-16T04:29:55Z,sentiment,gpt-4.1-mini,1947,238,2185
2025-09-16T04:29:56Z,pre_sentiment,gpt-4.1-mini,289,1,290
2025-09-16T04:29:59Z,sentiment,gpt-4.1-mini,1568,219,1787
2025-09-16T04:29:59Z,pre_sentiment,gpt-4.1-mini,286,1,287
2025-09-16T04:29:59Z,pre_sentiment,gpt-4.1-mini,282,1,283
2025-09-16T04:30:11Z,pre_sentiment,gpt-4.1-mini,280,1,281
2025-09-16T04:30:11Z,pre_sentiment,gpt-4.1-mini,286,1,287
2025-09-16T04:30:15Z,sentiment,gpt-4.1-mini,2457,225,2682
2025-09-16T04:30:15Z,pre_sentiment,gpt-4.1-mini,279,1,280
2025-09-16T04:30:26Z,pre_sentiment,gpt-4.1-mini,296,1,297
2025-09-16T04:30:27Z,pre_sentiment,gpt-4.1-mini,283,1,284
2025-09-16T04:30:30Z,sentiment,gpt-4.1-mini,1347,183,1530
2025-09-16T04:30:30Z,pre_sentiment,gpt-4.1-mini,285,1,286
2025-09-16T04:30:33Z,sentiment,gpt-4.1-mini,1129,112,1241
2025-09-16T04:30:33Z,pre_sentiment,gpt-4.1-mini,285,1,286
2025-09-16T04:30:33Z,pre_sentiment,gpt-4.1-mini,282,1,283
2025-09-16T04:30:35Z,sentiment,gpt-4.1-mini,1034,129,1163
2025-09-16T04:30:36Z,pre_sentiment,gpt-4.1-mini,287,1,288
2025-09-16T04:30:39Z,sentiment,gpt-4.1-mini,1240,196,1436
2025-09-16T04:30:49Z,article_selection,gpt-4.1-mini,1290,9,1299
2025-09-16T04:30:50Z,article_selection,gpt-4.1-mini,999,9,1008
2025-09-16T04:30:50Z,article_selection,gpt-4.1-mini,1329,12,1341
2025-09-16T04:30:51Z,article_selection,gpt-4.1-mini,3142,16,3158
2025-09-16T04:30:51Z,article_selection,gpt-4.1-mini,598,9,607
2025-09-16T04:30:52Z,article_selection,gpt-4.1-mini,419,6,425
2025-09-16T04:31:02Z,final_summary_en,gpt-4.1-mini,1142,924,2066
2025-09-16T04:31:13Z,final_summary_en,gpt-4.1-mini,1559,1130,2689
2025-09-16T04:31:24Z,final_summary_en,gpt-4.1-mini,1986,1104,3090
2025-09-16T04:31:35Z,final_summary_en,gpt-4.1-mini,1865,1211,3076
2025-09-16T04:31:45Z,final_summary_en,gpt-4.1-mini,885,1130,2015
2025-09-16T04:31:56Z,final_summary_en,gpt-4.1-mini,1435,1201,2636
2025-09-16T04:32:06Z,final_summary_en,gpt-4.1-mini,2292,1126,3418
2025-09-16T04:32:14Z,final_summary_en,gpt-4.1-mini,1092,906,1998
2025-09-16T04:32:26Z,final_summary_en,gpt-4.1-mini,1163,1252,2415
2025-09-16T04:32:39Z,final_summary_en,gpt-4.1-mini,1109,1415,2524
2025-09-16T04:32:51Z,final_summary_en,gpt-4.1-mini,1267,1159,2426
2025-09-16T04:33:02Z,final_summary_en,gpt-4.1-mini,1734,1101,2835
2025-09-16T04:33:12Z,final_summary_en,gpt-4.1-mini,1220,1038,2258
2025-09-16T04:33:24Z,final_summary_en,gpt-4.1-mini,2159,1230,3389
2025-09-16T04:33:37Z,final_summary_en,gpt-4.1-mini,1718,1203,2921
2025-09-16T04:33:49Z,final_summary_en,gpt-4.1-mini,1314,1145,2459
2025-09-16T04:34:01Z,final_summary_en,gpt-4.1-mini,1761,1264,3025
2025-09-16T04:34:17Z,final_summary_en,gpt-4.1-mini,2437,1373,3810
2025-09-16T04:34:26Z,final_summary_en,gpt-4.1-mini,731,811,1542
2025-09-16T04:34:40Z,final_summary_en,gpt-4.1-mini,1824,1442,3266
2025-09-16T04:34:48Z,final_summary_en,gpt-4.1-mini,1425,835,2260
2025-09-16T04:34:58Z,final_summary_en,gpt-4.1-mini,1548,1185,2733
2025-09-16T04:36:13Z,category_summary,gpt-4.1-mini,126,33,159
2025-09-16T04:36:15Z,category_summary,gpt-4.1-mini,147,35,182
2025-09-16T04:36:17Z,category_summary,gpt-4.1-mini,128,27,155
2025-09-16T04:36:19Z,category_summary,gpt-4.1-mini,133,32,165
2025-09-16T04:36:20Z,category_summary,gpt-4.1-mini,106,36,142
2025-09-16T04:36:23Z,category_summary,gpt-4.1-mini,102,30,132
2025-09-16T04:36:24Z,RUN_TOTAL,,178101,36700,214801
2025-09-17T04:24:48Z,pre_sentiment,gpt-4.1-mini,291,1,292
2025-09-17T04:24:51Z,sentiment,gpt-4.1-mini,1542,169,1711
2025-09-17T04:24:52Z,pre_sentiment,gpt-4.1-mini,285,1,286
2025-09-17T04:24:53Z,pre_sentiment,gpt-4.1-mini,287,1,288
2025-09-17T04:24:56Z,sentiment,gpt-4.1-mini,1714,226,1940
2025-09-17T04:24:56Z,pre_sentiment,gpt-4.1-mini,279,1,280
2025-09-17T04:24:58Z,sentiment,gpt-4.1-mini,1414,155,1569
2025-09-17T04:24:59Z,pre_sentiment,gpt-4.1-mini,287,1,288
2025-09-17T04:25:00Z,pre_sentiment,gpt-4.1-mini,290,1,291
2025-09-17T04:25:03Z,sentiment,gpt-4.1-mini,1410,200,1610
2025-09-17T04:25:03Z,pre_sentiment,gpt-4.1-mini,280,1,281
2025-09-17T04:25:03Z,pre_sentiment,gpt-4.1-mini,285,1,286
2025-09-17T04:25:04Z,pre_sentiment,gpt-4.1-mini,287,1,288
2025-09-17T04:25:04Z,pre_sentiment,gpt-4.1-mini,280,1,281
2025-09-17T04:25:05Z,pre_sentiment,gpt-4.1-mini,282,1,283
2025-09-17T04:25:05Z,pre_sentiment,gpt-4.1-mini,283,1,284
2025-09-17T04:25:06Z,pre_sentiment,gpt-4.1-mini,287,1,288
2025-09-17T04:25:17Z,pre_sentiment,gpt-4.1-mini,280,1,281
2025-09-17T04:25:20Z,sentiment,gpt-4.1-mini,1336,152,1488
2025-09-17T04:25:20Z,pre_sentiment,gpt-4.1-mini,285,1,286
2025-09-17T04:25:22Z,sentiment,gpt-4.1-mini,1504,151,1655
2025-09-17T04:25:34Z,pre_sentiment,gpt-4.1-mini,290,1,291
2025-09-17T04:25:38Z,sentiment,gpt-4.1-mini,2133,191,2324
2025-09-17T04:25:38Z,pre_sentiment,gpt-4.1-mini,283,1,284
2025-09-17T04:25:40Z,sentiment,gpt-4.1-mini,1287,155,1442
2025-09-17T04:25:40Z,pre_sentiment,gpt-4.1-mini,300,1,301
2025-09-17T04:25:43Z,sentiment,gpt-4.1-mini,2148,233,2381
2025-09-17T04:25:44Z,pre_sentiment,gpt-4.1-mini,282,1,283
2025-09-17T04:25:46Z,sentiment,gpt-4.1-mini,1485,185,1670
2025-09-17T04:25:47Z,pre_sentiment,gpt-4.1-mini,283,1,284
2025-09-17T04:25:49Z,sentiment,gpt-4.1-mini,1429,177,1606
2025-09-17T04:25:49Z,pre_sentiment,gpt-4.1-mini,283,1,284
2025-09-17T04:25:53Z,sentiment,gpt-4.1-mini,1339,193,1532
2025-09-17T04:25:53Z,pre_sentiment,gpt-4.1-mini,279,1,280
2025-09-17T04:25:53Z,pre_sentiment,gpt-4.1-mini,284,1,285
2025-09-17T04:25:56Z,sentiment,gpt-4.1-mini,1547,196,1743
2025-09-17T04:25:56Z,pre_sentiment,gpt-4.1-mini,277,1,278
2025-09-17T04:26:01Z,sentiment,gpt-4.1-mini,1442,207,1649
2025-09-17T04:26:03Z,pre_sentiment,gpt-4.1-mini,281,1,282
2025-09-17T04:26:06Z,sentiment,gpt-4.1-mini,1400,227,1627
2025-09-17T04:26:06Z,pre_sentiment,gpt-4.1-mini,290,1,291
2025-09-17T04:26:09Z,sentiment,gpt-4.1-mini,1622,175,1797
2025-09-17T04:26:24Z,pre_sentiment,gpt-4.1-mini,295,1,296
2025-09-17T04:26:26Z,sentiment,gpt-4.1-mini,1145,171,1316
2025-09-17T04:26:27Z,pre_sentiment,gpt-4.1-mini,306,1,307
2025-09-17T04:26:28Z,sentiment,gpt-4.1-mini,1026,106,1132
2025-09-17T04:26:28Z,pre_sentiment,gpt-4.1-mini,297,1,298
2025-09-17T04:26:30Z,sentiment,gpt-4.1-mini,908,88,996
2025-09-17T04:26:30Z,pre_sentiment,gpt-4.1-mini,299,1,300
2025-09-17T04:26:30Z,pre_sentiment,gpt-4.1-mini,300,1,301
2025-09-17T04:26:32Z,sentiment,gpt-4.1-mini,929,106,1035
2025-09-17T04:26:33Z,pre_sentiment,gpt-4.1-mini,295,1,296
2025-09-17T04:26:34Z,sentiment,gpt-4.1-mini,1009,151,1160
2025-09-17T04:26:35Z,pre_sentiment,gpt-4.1-mini,296,1,297
2025-09-17T04:26:35Z,pre_sentiment,gpt-4.1-mini,293,1,294
2025-09-17T04:26:37Z,sentiment,gpt-4.1-mini,901,92,993
2025-09-17T04:26:37Z,pre_sentiment,gpt-4.1-mini,300,1,301
2025-09-17T04:26:39Z,sentiment,gpt-4.1-mini,919,123,1042
2025-09-17T04:26:39Z,pre_sentiment,gpt-4.1-mini,298,1,299
2025-09-17T04:26:39Z,pre_sentiment,gpt-4.1-mini,300,1,301
2025-09-17T04:26:42Z,sentiment,gpt-4.1-mini,1842,179,2021
2025-09-17T04:26:43Z,pre_sentiment,gpt-4.1-mini,301,1,302
2025-09-17T04:26:46Z,sentiment,gpt-4.1-mini,2735,211,2946
2025-09-17T04:26:47Z,pre_sentiment,gpt-4.1-mini,298,1,299
2025-09-17T04:26:47Z,pre_sentiment,gpt-4.1-mini,299,1,300
2025-09-17T04:26:50Z,sentiment,gpt-4.1-mini,2008,224,2232
2025-09-17T04:26:50Z,pre_sentiment,gpt-4.1-mini,299,1,300
2025-09-17T04:26:53Z,sentiment,gpt-4.1-mini,1420,172,1592
2025-09-17T04:27:09Z,pre_sentiment,gpt-4.1-mini,283,1,284
2025-09-17T04:27:12Z,sentiment,gpt-4.1-mini,1443,181,1624
2025-09-17T04:27:12Z,pre_sentiment,gpt-4.1-mini,276,1,277
2025-09-17T04:27:14Z,sentiment,gpt-4.1-mini,867,98,965
2025-09-17T04:27:15Z,pre_sentiment,gpt-4.1-mini,289,1,290
2025-09-17T04:27:17Z,sentiment,gpt-4.1-mini,1129,157,1286
2025-09-17T04:27:18Z,pre_sentiment,gpt-4.1-mini,280,1,281
2025-09-17T04:27:20Z,sentiment,gpt-4.1-mini,1136,132,1268
2025-09-17T04:27:20Z,pre_sentiment,gpt-4.1-mini,286,1,287
2025-09-17T04:27:23Z,sentiment,gpt-4.1-mini,1624,200,1824
2025-09-17T04:27:23Z,pre_sentiment,gpt-4.1-mini,283,1,284
2025-09-17T04:27:32Z,sentiment,gpt-4.1-mini,2490,240,2730
2025-09-17T04:27:32Z,pre_sentiment,gpt-4.1-mini,291,1,292
2025-09-17T04:27:35Z,sentiment,gpt-4.1-mini,1193,154,1347
2025-09-17T04:27:40Z,pre_sentiment,gpt-4.1-mini,290,1,291
2025-09-17T04:27:43Z,sentiment,gpt-4.1-mini,2189,184,2373
2025-09-17T04:27:44Z,pre_sentiment,gpt-4.1-mini,280,1,281
2025-09-17T04:27:46Z,sentiment,gpt-4.1-mini,1838,148,1986
2025-09-17T04:27:50Z,pre_sentiment,gpt-4.1-mini,264,1,265
2025-09-17T04:27:51Z,pre_sentiment,gpt-4.1-mini,265,1,266
2025-09-17T04:27:54Z,sentiment,gpt-4.1-mini,3223,217,3440
2025-09-17T04:27:54Z,pre_sentiment,gpt-4.1-mini,273,1,274
2025-09-17T04:27:58Z,pre_sentiment,gpt-4.1-mini,277,1,278
2025-09-17T04:28:04Z,sentiment,gpt-4.1-mini,3851,249,4100
2025-09-17T04:28:04Z,pre_sentiment,gpt-4.1-mini,279,1,280
2025-09-17T04:28:04Z,pre_sentiment,gpt-4.1-mini,275,1,276
2025-09-17T04:28:05Z,pre_sentiment,gpt-4.1-mini,280,1,281
2025-09-17T04:28:07Z,sentiment,gpt-4.1-mini,2522,126,2648
2025-09-17T04:28:07Z,pre_sentiment,gpt-4.1-mini,277,1,278
2025-09-17T04:28:07Z,pre_sentiment,gpt-4.1-mini,272,1,273
2025-09-17T04:28:08Z,pre_sentiment,gpt-4.1-mini,274,1,275
2025-09-17T04:28:08Z,pre_sentiment,gpt-4.1-mini,280,1,281
2025-09-17T04:28:08Z,pre_sentiment,gpt-4.1-mini,276,1,277
2025-09-17T04:28:10Z,sentiment,gpt-4.1-mini,3960,137,4097
2025-09-17T04:28:14Z,pre_sentiment,gpt-4.1-mini,283,1,284
2025-09-17T04:28:14Z,pre_sentiment,gpt-4.1-mini,283,1,284
2025-09-17T04:28:16Z,sentiment,gpt-4.1-mini,2136,178,2314
2025-09-17T04:28:17Z,pre_sentiment,gpt-4.1-mini,287,1,288
2025-09-17T04:28:20Z,sentiment,gpt-4.1-mini,2450,222,2672
2025-09-17T04:28:20Z,pre_sentiment,gpt-4.1-mini,289,1,290
2025-09-17T04:28:23Z,sentiment,gpt-4.1-mini,2117,202,2319
2025-09-17T04:28:23Z,pre_sentiment,gpt-4.1-mini,284,1,285
2025-09-17T04:28:23Z,pre_sentiment,gpt-4.1-mini,282,1,283
2025-09-17T04:28:28Z,sentiment,gpt-4.1-mini,1528,202,1730
2025-09-17T04:28:28Z,pre_sentiment,gpt-4.1-mini,284,1,285
2025-09-17T04:28:31Z,sentiment,gpt-4.1-mini,1518,177,1695
2025-09-17T04:28:32Z,pre_sentiment,gpt-4.1-mini,280,1,281
2025-09-17T04:28:42Z,pre_sentiment,gpt-4.1-mini,290,1,291
2025-09-17T04:28:45Z,sentiment,gpt-4.1-mini,1237,188,1425
2025-09-17T04:28:45Z,pre_sentiment,gpt-4.1-mini,281,1,282
2025-09-17T04:28:45Z,pre_sentiment,gpt-4.1-mini,285,1,286
2025-09-17T04:28:56Z,pre_sentiment,gpt-4.1-mini,284,1,285
2025-09-17T04:29:03Z,pre_sentiment,gpt-4.1-mini,287,1,288
2025-09-17T04:29:06Z,sentiment,gpt-4.1-mini,1724,157,1881
2025-09-17T04:29:21Z,pre_sentiment,gpt-4.1-mini,285,1,286
2025-09-17T04:29:21Z,pre_sentiment,gpt-4.1-mini,288,1,289
2025-09-17T04:29:21Z,pre_sentiment,gpt-4.1-mini,283,1,284
2025-09-17T04:29:25Z,sentiment,gpt-4.1-mini,1232,200,1432
2025-09-17T04:29:25Z,pre_sentiment,gpt-4.1-mini,285,1,286
2025-09-17T04:29:29Z,sentiment,gpt-4.1-mini,1473,191,1664
2025-09-17T04:29:29Z,pre_sentiment,gpt-4.1-mini,295,1,296
2025-09-17T04:29:32Z,sentiment,gpt-4.1-mini,1347,162,1509
2025-09-17T04:29:32Z,pre_sentiment,gpt-4.1-mini,286,1,287
2025-09-17T04:29:33Z,pre_sentiment,gpt-4.1-mini,293,1,294
2025-09-17T04:29:34Z,pre_sentiment,gpt-4.1-mini,276,1,277
2025-09-17T04:29:47Z,pre_sentiment,gpt-4.1-mini,285,1,286
2025-09-17T04:29:47Z,pre_sentiment,gpt-4.1-mini,275,1,276
2025-09-17T04:29:47Z,pre_sentiment,gpt-4.1-mini,278,1,279
2025-09-17T04:29:50Z,sentiment,gpt-4.1-mini,1533,182,1715
2025-09-17T04:29:50Z,pre_sentiment,gpt-4.1-mini,280,1,281
2025-09-17T04:30:01Z,pre_sentiment,gpt-4.1-mini,295,1,296
2025-09-17T04:30:02Z,pre_sentiment,gpt-4.1-mini,290,1,291
2025-09-17T04:30:02Z,pre_sentiment,gpt-4.1-mini,285,1,286
2025-09-17T04:30:02Z,pre_sentiment,gpt-4.1-mini,287,1,288
2025-09-17T04:30:03Z,pre_sentiment,gpt-4.1-mini,279,1,280
2025-09-17T04:30:03Z,pre_sentiment,gpt-4.1-mini,281,1,282
2025-09-17T04:30:11Z,article_selection,gpt-4.1-mini,759,12,771
2025-09-17T04:30:12Z,article_selection,gpt-4.1-mini,1718,16,1734
2025-09-17T04:30:14Z,article_selection,gpt-4.1-mini,1170,12,1182
2025-09-17T04:30:15Z,article_selection,gpt-4.1-mini,675,12,687
2025-09-17T04:30:16Z,article_selection,gpt-4.1-mini,2454,7,2461
2025-09-17T04:30:27Z,final_summary_en,gpt-4.1-mini,1888,1288,3176
2025-09-17T04:30:38Z,final_summary_en,gpt-4.1-mini,1170,1187,2357
2025-09-17T04:30:56Z,final_summary_en,gpt-4.1-mini,2265,1401,3666
2025-09-17T04:31:09Z,final_summary_en,gpt-4.1-mini,1394,1360,2754
2025-09-17T04:31:24Z,final_summary_en,gpt-4.1-mini,1293,1252,2545
2025-09-17T04:31:39Z,final_summary_en,gpt-4.1-mini,2492,1046,3538
2025-09-17T04:31:48Z,final_summary_en,gpt-4.1-mini,1236,930,2166
2025-09-17T04:31:58Z,final_summary_en,gpt-4.1-mini,1194,1005,2199
2025-09-17T04:32:13Z,final_summary_en,gpt-4.1-mini,1577,1103,2680
2025-09-17T04:32:25Z,final_summary_en,gpt-4.1-mini,1234,1302,2536
2025-09-17T04:32:40Z,final_summary_en,gpt-4.1-mini,1764,1241,3005
2025-09-17T04:32:56Z,final_summary_en,gpt-4.1-mini,2982,1276,4258
2025-09-17T04:33:11Z,final_summary_en,gpt-4.1-mini,1160,995,2155
2025-09-17T04:33:22Z,final_summary_en,gpt-4.1-mini,1292,1225,2517
2025-09-17T04:33:33Z,final_summary_en,gpt-4.1-mini,1490,1158,2648
2025-09-17T04:33:45Z,final_summary_en,gpt-4.1-mini,1184,1135,2319
2025-09-17T04:34:00Z,final_summary_en,gpt-4.1-mini,3635,1347,4982
2025-09-17T04:34:09Z,final_summary_en,gpt-4.1-mini,972,1015,1987
2025-09-17T04:34:18Z,final_summary_en,gpt-4.1-mini,989,1037,2026
2025-09-17T04:35:16Z,category_summary,gpt-4.1-mini,128,33,161
2025-09-17T04:35:18Z,category_summary,gpt-4.1-mini,135,27,162
2025-09-17T04:35:24Z,category_summary,gpt-4.1-mini,132,24,156
2025-09-17T04:35:25Z,category_summary,gpt-4.1-mini,119,38,157
2025-09-17T04:35:27Z,category_summary,gpt-4.1-mini,137,38,175
2025-09-17T04:35:28Z,RUN_TOTAL,,150543,31514,182057
2025-09-18T04:25:20Z,pre_sentiment,gpt-4.1-mini,283,1,284
2025-09-18T04:25:21Z,pre_sentiment,gpt-4.1-mini,284,1,285
2025-09-18T04:25:24Z,sentiment,gpt-4.1-mini,1195,170,1365
2025-09-18T04:25:26Z,pre_sentiment,gpt-4.1-mini,284,1,285
2025-09-18T04:25:27Z,pre_sentiment,gpt-4.1-mini,280,1,281
2025-09-18T04:25:28Z,pre_sentiment,gpt-4.1-mini,282,1,283
2025-09-18T04:25:28Z,pre_sentiment,gpt-4.1-mini,283,1,284
2025-09-18T04:25:29Z,pre_sentiment,gpt-4.1-mini,282,1,283
2025-09-18T04:25:30Z,pre_sentiment,gpt-4.1-mini,279,1,280
2025-09-18T04:25:30Z,pre_sentiment,gpt-4.1-mini,282,1,283
2025-09-18T04:25:30Z,pre_sentiment,gpt-4.1-mini,280,1,281
2025-09-18T04:25:33Z,sentiment,gpt-4.1-mini,1499,219,1718
2025-09-18T04:25:34Z,pre_sentiment,gpt-4.1-mini,283,1,284
2025-09-18T04:25:38Z,sentiment,gpt-4.1-mini,1547,203,1750
2025-09-18T04:25:38Z,pre_sentiment,gpt-4.1-mini,290,1,291
2025-09-18T04:25:39Z,pre_sentiment,gpt-4.1-mini,281,1,282
2025-09-18T04:25:39Z,pre_sentiment,gpt-4.1-mini,295,1,296
2025-09-18T04:25:48Z,pre_sentiment,gpt-4.1-mini,281,1,282
2025-09-18T04:25:51Z,sentiment,gpt-4.1-mini,1415,164,1579
2025-09-18T04:25:52Z,pre_sentiment,gpt-4.1-mini,280,1,281
2025-09-18T04:25:52Z,pre_sentiment,gpt-4.1-mini,283,1,284
2025-09-18T04:26:00Z,pre_sentiment,gpt-4.1-mini,284,1,285
2025-09-18T04:26:02Z,sentiment,gpt-4.1-mini,1318,164,1482
2025-09-18T04:26:06Z,pre_sentiment,gpt-4.1-mini,282,1,283
2025-09-18T04:26:09Z,sentiment,gpt-4.1-mini,1644,208,1852
2025-09-18T04:26:09Z,pre_sentiment,gpt-4.1-mini,286,1,287
2025-09-18T04:26:14Z,sentiment,gpt-4.1-mini,2040,223,2263
2025-09-18T04:26:15Z,pre_sentiment,gpt-4.1-mini,283,1,284
2025-09-18T04:26:18Z,sentiment,gpt-4.1-mini,1814,216,2030
2025-09-18T04:26:18Z,pre_sentiment,gpt-4.1-mini,277,1,278
2025-09-18T04:26:21Z,sentiment,gpt-4.1-mini,1563,190,1753
2025-09-18T04:26:22Z,pre_sentiment,gpt-4.1-mini,282,1,283
2025-09-18T04:26:24Z,sentiment,gpt-4.1-mini,1379,161,1540
2025-09-18T04:26:25Z,pre_sentiment,gpt-4.1-mini,282,1,283
2025-09-18T04:26:28Z,sentiment,gpt-4.1-mini,1885,238,2123
2025-09-18T04:26:28Z,pre_sentiment,gpt-4.1-mini,283,1,284
2025-09-18T04:26:31Z,sentiment,gpt-4.1-mini,1256,194,1450
2025-09-18T04:26:31Z,pre_sentiment,gpt-4.1-mini,278,1,279
2025-09-18T04:26:33Z,sentiment,gpt-4.1-mini,1731,172,1903
2025-09-18T04:26:34Z,pre_sentiment,gpt-4.1-mini,276,1,277
2025-09-18T04:26:37Z,sentiment,gpt-4.1-mini,1625,198,1823
2025-09-18T04:26:37Z,pre_sentiment,gpt-4.1-mini,279,1,280
2025-09-18T04:26:40Z,sentiment,gpt-4.1-mini,1696,191,1887
2025-09-18T04:26:41Z,pre_sentiment,gpt-4.1-mini,283,1,284
2025-09-18T04:26:46Z,sentiment,gpt-4.1-mini,2288,191,2479
2025-09-18T04:26:46Z,pre_sentiment,gpt-4.1-mini,300,1,301
2025-09-18T04:26:49Z,sentiment,gpt-4.1-mini,2148,196,2344
2025-09-18T04:27:14Z,pre_sentiment,gpt-4.1-mini,295,1,296
2025-09-18T04:27:16Z,sentiment,gpt-4.1-mini,920,162,1082
2025-09-18T04:27:16Z,pre_sentiment,gpt-4.1-mini,308,1,309
2025-09-18T04:27:19Z,sentiment,gpt-4.1-mini,1412,194,1606
2025-09-18T04:27:20Z,pre_sentiment,gpt-4.1-mini,290,1,291
2025-09-18T04:27:22Z,sentiment,gpt-4.1-mini,1357,175,1532
2025-09-18T04:27:23Z,pre_sentiment,gpt-4.1-mini,303,1,304
2025-09-18T04:27:26Z,sentiment,gpt-4.1-mini,17233,226,17459
2025-09-18T04:27:27Z,pre_sentiment,gpt-4.1-mini,291,1,292
2025-09-18T04:27:31Z,sentiment,gpt-4.1-mini,12016,269,12285
2025-09-18T04:27:32Z,pre_sentiment,gpt-4.1-mini,309,1,310
2025-09-18T04:27:35Z,sentiment,gpt-4.1-mini,4052,218,4270
2025-09-18T04:27:35Z,pre_sentiment,gpt-4.1-mini,293,1,294
2025-09-18T04:27:39Z,sentiment,gpt-4.1-mini,7032,241,7273
2025-09-18T04:27:39Z,pre_sentiment,gpt-4.1-mini,298,1,299
2025-09-18T04:27:39Z,pre_sentiment,gpt-4.1-mini,293,1,294
2025-09-18T04:27:42Z,sentiment,gpt-4.1-mini,4315,185,4500
2025-09-18T04:27:42Z,pre_sentiment,gpt-4.1-mini,291,1,292
2025-09-18T04:27:45Z,sentiment,gpt-4.1-mini,4686,185,4871
2025-09-18T04:27:46Z,pre_sentiment,gpt-4.1-mini,304,1,305
2025-09-18T04:27:48Z,sentiment,gpt-4.1-mini,1307,205,1512
2025-09-18T04:27:49Z,pre_sentiment,gpt-4.1-mini,298,1,299
2025-09-18T04:27:53Z,sentiment,gpt-4.1-mini,13678,266,13944
2025-09-18T04:27:53Z,pre_sentiment,gpt-4.1-mini,300,1,301
2025-09-18T04:27:56Z,sentiment,gpt-4.1-mini,1628,218,1846
2025-09-18T04:27:56Z,pre_sentiment,gpt-4.1-mini,296,1,297
2025-09-18T04:27:59Z,sentiment,gpt-4.1-mini,1690,173,1863
2025-09-18T04:27:59Z,pre_sentiment,gpt-4.1-mini,301,1,302
2025-09-18T04:28:02Z,sentiment,gpt-4.1-mini,7274,199,7473
2025-09-18T04:28:16Z,pre_sentiment,gpt-4.1-mini,283,1,284
2025-09-18T04:28:20Z,sentiment,gpt-4.1-mini,1762,190,1952
2025-09-18T04:28:20Z,pre_sentiment,gpt-4.1-mini,285,1,286
2025-09-18T04:28:23Z,sentiment,gpt-4.1-mini,2430,209,2639
2025-09-18T04:28:24Z,pre_sentiment,gpt-4.1-mini,280,1,281
2025-09-18T04:28:27Z,sentiment,gpt-4.1-mini,1209,151,1360
2025-09-18T04:28:27Z,pre_sentiment,gpt-4.1-mini,279,1,280
2025-09-18T04:28:28Z,pre_sentiment,gpt-4.1-mini,274,1,275
2025-09-18T04:28:30Z,sentiment,gpt-4.1-mini,976,172,1148
2025-09-18T04:28:30Z,pre_sentiment,gpt-4.1-mini,287,1,288
2025-09-18T04:28:33Z,sentiment,gpt-4.1-mini,2262,191,2453
2025-09-18T04:28:40Z,pre_sentiment,gpt-4.1-mini,290,1,291
2025-09-18T04:28:43Z,sentiment,gpt-4.1-mini,1260,223,1483
2025-09-18T04:28:55Z,pre_sentiment,gpt-4.1-mini,288,1,289
2025-09-18T04:28:59Z,sentiment,gpt-4.1-mini,2313,260,2573
2025-09-18T04:29:00Z,pre_sentiment,gpt-4.1-mini,267,1,268
2025-09-18T04:29:00Z,pre_sentiment,gpt-4.1-mini,292,1,293
2025-09-18T04:29:00Z,pre_sentiment,gpt-4.1-mini,266,1,267
2025-09-18T04:29:06Z,pre_sentiment,gpt-4.1-mini,278,1,279
2025-09-18T04:29:06Z,pre_sentiment,gpt-4.1-mini,283,1,284
2025-09-18T04:29:06Z,pre_sentiment,gpt-4.1-mini,274,1,275
2025-09-18T04:29:09Z,sentiment,gpt-4.1-mini,2432,213,2645
2025-09-18T04:29:09Z,pre_sentiment,gpt-4.1-mini,276,1,277
2025-09-18T04:29:09Z,pre_sentiment,gpt-4.1-mini,275,1,276
2025-09-18T04:29:10Z,pre_sentiment,gpt-4.1-mini,279,1,280
2025-09-18T04:29:15Z,pre_sentiment,gpt-4.1-mini,281,1,282
2025-09-18T04:29:20Z,sentiment,gpt-4.1-mini,1554,208,1762
2025-09-18T04:29:20Z,pre_sentiment,gpt-4.1-mini,284,1,285
2025-09-18T04:29:23Z,sentiment,gpt-4.1-mini,1664,170,1834
2025-09-18T04:29:24Z,pre_sentiment,gpt-4.1-mini,286,1,287
2025-09-18T04:29:26Z,sentiment,gpt-4.1-mini,1373,195,1568
2025-09-18T04:29:27Z,pre_sentiment,gpt-4.1-mini,285,1,286
2025-09-18T04:29:29Z,sentiment,gpt-4.1-mini,1427,156,1583
2025-09-18T04:29:29Z,pre_sentiment,gpt-4.1-mini,282,1,283
2025-09-18T04:29:32Z,sentiment,gpt-4.1-mini,1549,207,1756
2025-09-18T04:29:33Z,pre_sentiment,gpt-4.1-mini,288,1,289
2025-09-18T04:29:36Z,sentiment,gpt-4.1-mini,1816,226,2042
2025-09-18T04:29:36Z,pre_sentiment,gpt-4.1-mini,289,1,290
2025-09-18T04:29:38Z,sentiment,gpt-4.1-mini,1622,144,1766
2025-09-18T04:29:45Z,pre_sentiment,gpt-4.1-mini,287,1,288
2025-09-18T04:29:47Z,sentiment,gpt-4.1-mini,1155,165,1320
2025-09-18T04:29:48Z,pre_sentiment,gpt-4.1-mini,288,1,289
2025-09-18T04:29:53Z,pre_sentiment,gpt-4.1-mini,283,1,284
2025-09-18T04:29:55Z,sentiment,gpt-4.1-mini,1105,152,1257
2025-09-18T04:29:59Z,pre_sentiment,gpt-4.1-mini,288,1,289
2025-09-18T04:30:08Z,pre_sentiment,gpt-4.1-mini,284,1,285
2025-09-18T04:30:45Z,pre_sentiment,gpt-4.1-mini,289,1,290
2025-09-18T04:30:48Z,sentiment,gpt-4.1-mini,1610,202,1812
2025-09-18T04:30:48Z,pre_sentiment,gpt-4.1-mini,293,1,294
2025-09-18T04:30:51Z,sentiment,gpt-4.1-mini,1673,160,1833
2025-09-18T04:31:01Z,pre_sentiment,gpt-4.1-mini,289,1,290
2025-09-18T04:31:04Z,sentiment,gpt-4.1-mini,1544,195,1739
2025-09-18T04:31:04Z,pre_sentiment,gpt-4.1-mini,278,1,279
2025-09-18T04:31:07Z,sentiment,gpt-4.1-mini,1307,175,1482
2025-09-18T04:31:18Z,pre_sentiment,gpt-4.1-mini,298,1,299
2025-09-18T04:31:20Z,sentiment,gpt-4.1-mini,1833,202,2035
2025-09-18T04:31:34Z,pre_sentiment,gpt-4.1-mini,281,1,282
2025-09-18T04:31:35Z,pre_sentiment,gpt-4.1-mini,283,1,284
2025-09-18T04:31:38Z,sentiment,gpt-4.1-mini,2722,245,2967
2025-09-18T04:31:39Z,pre_sentiment,gpt-4.1-mini,287,1,288
2025-09-18T04:31:42Z,sentiment,gpt-4.1-mini,2266,221,2487
2025-09-18T04:31:43Z,pre_sentiment,gpt-4.1-mini,285,1,286
2025-09-18T04:31:57Z,pre_sentiment,gpt-4.1-mini,282,1,283
2025-09-18T04:31:57Z,pre_sentiment,gpt-4.1-mini,289,1,290
2025-09-18T04:31:57Z,pre_sentiment,gpt-4.1-mini,278,1,279
2025-09-18T04:32:00Z,sentiment,gpt-4.1-mini,1141,191,1332
2025-09-18T04:32:01Z,pre_sentiment,gpt-4.1-mini,277,1,278
2025-09-18T04:32:01Z,pre_sentiment,gpt-4.1-mini,294,1,295
2025-09-18T04:32:01Z,pre_sentiment,gpt-4.1-mini,294,1,295
2025-09-18T04:32:04Z,sentiment,gpt-4.1-mini,1445,186,1631
2025-09-18T04:32:04Z,pre_sentiment,gpt-4.1-mini,284,1,285
2025-09-18T04:32:07Z,sentiment,gpt-4.1-mini,2138,203,2341
2025-09-18T04:32:08Z,pre_sentiment,gpt-4.1-mini,284,1,285
2025-09-18T04:32:16Z,article_selection,gpt-4.1-mini,3244,16,3260
2025-09-18T04:32:17Z,article_selection,gpt-4.1-mini,1394,12,1406
2025-09-18T04:32:17Z,article_selection,gpt-4.1-mini,2125,12,2137
2025-09-18T04:32:18Z,article_selection,gpt-4.1-mini,1075,16,1091
2025-09-18T04:32:19Z,article_selection,gpt-4.1-mini,484,5,489
2025-09-18T04:32:38Z,final_summary_en,gpt-4.1-mini,1382,1036,2418
2025-09-18T04:32:53Z,final_summary_en,gpt-4.1-mini,1310,1010,2320
2025-09-18T04:33:10Z,final_summary_en,gpt-4.1-mini,1403,996,2399
2025-09-18T04:33:29Z,final_summary_en,gpt-4.1-mini,1815,1178,2993
2025-09-18T04:33:56Z,final_summary_en,gpt-4.1-mini,1581,1166,2747
2025-09-18T04:34:14Z,final_summary_en,gpt-4.1-mini,2085,1212,3297
2025-09-18T04:34:29Z,final_summary_en,gpt-4.1-mini,892,792,1684
2025-09-18T04:34:46Z,final_summary_en,gpt-4.1-mini,2502,1129,3631
2025-09-18T04:35:07Z,final_summary_en,gpt-4.1-mini,2200,1262,3462
2025-09-18T04:35:21Z,final_summary_en,gpt-4.1-mini,1054,991,2045
2025-09-18T04:35:39Z,final_summary_en,gpt-4.1-mini,1373,1234,2607
2025-09-18T04:36:00Z,final_summary_en,gpt-4.1-mini,1277,1118,2395
2025-09-18T04:36:18Z,final_summary_en,gpt-4.1-mini,1644,1185,2829
2025-09-18T04:36:42Z,final_summary_en,gpt-4.1-mini,996,1140,2136
2025-09-18T04:36:58Z,final_summary_en,gpt-4.1-mini,1517,1148,2665
2025-09-18T04:37:17Z,final_summary_en,gpt-4.1-mini,2188,1122,3310
2025-09-18T04:37:35Z,final_summary_en,gpt-4.1-mini,6802,1284,8086
2025-09-18T04:37:51Z,final_summary_en,gpt-4.1-mini,4445,1163,5608
2025-09-18T04:38:49Z,category_summary,gpt-4.1-mini,122,43,165
2025-09-18T04:38:51Z,category_summary,gpt-4.1-mini,132,23,155
2025-09-18T04:38:53Z,category_summary,gpt-4.1-mini,92,18,110
2025-09-18T04:38:55Z,category_summary,gpt-4.1-mini,129,41,170
2025-09-18T04:38:58Z,category_summary,gpt-4.1-mini,127,39,166
2025-09-18T04:38:59Z,RUN_TOTAL,,223624,31908,255532
2025-09-19T04:25:31Z,pre_sentiment,gpt-4.1-mini,282,1,283
2025-09-19T04:25:31Z,pre_sentiment,gpt-4.1-mini,283,1,284
2025-09-19T04:25:34Z,pre_sentiment,gpt-4.1-mini,287,1,288
2025-09-19T04:25:34Z,pre_sentiment,gpt-4.1-mini,290,1,291
2025-09-19T04:25:35Z,pre_sentiment,gpt-4.1-mini,288,1,289
2025-09-19T04:25:35Z,pre_sentiment,gpt-4.1-mini,281,1,282
2025-09-19T04:25:36Z,pre_sentiment,gpt-4.1-mini,285,1,286
2025-09-19T04:25:37Z,pre_sentiment,gpt-4.1-mini,291,1,292
2025-09-19T04:25:37Z,pre_sentiment,gpt-4.1-mini,289,1,290
2025-09-19T04:25:38Z,pre_sentiment,gpt-4.1-mini,278,1,279
2025-09-19T04:25:39Z,sentiment,gpt-4.1-mini,1153,120,1273
2025-09-19T04:25:40Z,pre_sentiment,gpt-4.1-mini,276,1,277
2025-09-19T04:25:43Z,sentiment,gpt-4.1-mini,1717,185,1902
2025-09-19T04:25:44Z,pre_sentiment,gpt-4.1-mini,283,1,284
2025-09-19T04:25:44Z,pre_sentiment,gpt-4.1-mini,286,1,287
2025-09-19T04:25:45Z,pre_sentiment,gpt-4.1-mini,281,1,282
2025-09-19T04:25:45Z,pre_sentiment,gpt-4.1-mini,283,1,284
2025-09-19T04:25:48Z,pre_sentiment,gpt-4.1-mini,282,1,283
2025-09-19T04:25:49Z,pre_sentiment,gpt-4.1-mini,279,1,280
2025-09-19T04:25:51Z,sentiment,gpt-4.1-mini,1516,174,1690
2025-09-19T04:25:55Z,pre_sentiment,gpt-4.1-mini,280,1,281
2025-09-19T04:25:55Z,pre_sentiment,gpt-4.1-mini,275,1,276
2025-09-19T04:25:57Z,sentiment,gpt-4.1-mini,1716,175,1891
2025-09-19T04:26:02Z,pre_sentiment,gpt-4.1-mini,278,1,279
2025-09-19T04:26:05Z,sentiment,gpt-4.1-mini,1714,184,1898
2025-09-19T04:26:05Z,pre_sentiment,gpt-4.1-mini,285,1,286
2025-09-19T04:26:09Z,sentiment,gpt-4.1-mini,1889,210,2099
2025-09-19T04:26:09Z,pre_sentiment,gpt-4.1-mini,280,1,281
2025-09-19T04:26:12Z,sentiment,gpt-4.1-mini,1396,189,1585
2025-09-19T04:26:13Z,pre_sentiment,gpt-4.1-mini,280,1,281
2025-09-19T04:26:13Z,pre_sentiment,gpt-4.1-mini,282,1,283
2025-09-19T04:26:16Z,sentiment,gpt-4.1-mini,1679,206,1885
2025-09-19T04:26:16Z,pre_sentiment,gpt-4.1-mini,279,1,280
2025-09-19T04:26:17Z,pre_sentiment,gpt-4.1-mini,282,1,283
2025-09-19T04:26:20Z,sentiment,gpt-4.1-mini,1766,202,1968
2025-09-19T04:26:20Z,pre_sentiment,gpt-4.1-mini,278,1,279
2025-09-19T04:26:23Z,sentiment,gpt-4.1-mini,2315,195,2510
2025-09-19T04:26:24Z,pre_sentiment,gpt-4.1-mini,287,1,288
2025-09-19T04:26:24Z,pre_sentiment,gpt-4.1-mini,275,1,276
2025-09-19T04:26:27Z,sentiment,gpt-4.1-mini,1687,226,1913
2025-09-19T04:26:28Z,pre_sentiment,gpt-4.1-mini,287,1,288
2025-09-19T04:26:30Z,sentiment,gpt-4.1-mini,1868,182,2050
2025-09-19T04:26:30Z,pre_sentiment,gpt-4.1-mini,278,1,279
2025-09-19T04:26:33Z,sentiment,gpt-4.1-mini,1656,196,1852
2025-09-19T04:26:33Z,pre_sentiment,gpt-4.1-mini,279,1,280
2025-09-19T04:26:36Z,sentiment,gpt-4.1-mini,1824,227,2051
2025-09-19T04:26:51Z,pre_sentiment,gpt-4.1-mini,295,1,296
2025-09-19T04:26:52Z,pre_sentiment,gpt-4.1-mini,316,1,317
2025-09-19T04:26:53Z,sentiment,gpt-4.1-mini,974,93,1067
2025-09-19T04:26:53Z,pre_sentiment,gpt-4.1-mini,297,1,298
2025-09-19T04:26:53Z,pre_sentiment,gpt-4.1-mini,293,1,294
2025-09-19T04:26:55Z,sentiment,gpt-4.1-mini,916,145,1061
2025-09-19T04:26:55Z,pre_sentiment,gpt-4.1-mini,301,1,302
2025-09-19T04:26:58Z,sentiment,gpt-4.1-mini,1738,199,1937
2025-09-19T04:26:58Z,pre_sentiment,gpt-4.1-mini,297,1,298
2025-09-19T04:26:59Z,pre_sentiment,gpt-4.1-mini,303,1,304
2025-09-19T04:27:01Z,sentiment,gpt-4.1-mini,1545,161,1706
2025-09-19T04:27:01Z,pre_sentiment,gpt-4.1-mini,294,1,295
2025-09-19T04:27:05Z,sentiment,gpt-4.1-mini,8330,254,8584
2025-09-19T04:27:05Z,pre_sentiment,gpt-4.1-mini,295,1,296
2025-09-19T04:27:08Z,sentiment,gpt-4.1-mini,920,136,1056
2025-09-19T04:27:08Z,pre_sentiment,gpt-4.1-mini,308,1,309
2025-09-19T04:27:11Z,sentiment,gpt-4.1-mini,1412,192,1604
2025-09-19T04:27:11Z,pre_sentiment,gpt-4.1-mini,290,1,291
2025-09-19T04:27:15Z,sentiment,gpt-4.1-mini,1357,210,1567
2025-09-19T04:27:15Z,pre_sentiment,gpt-4.1-mini,303,1,304
2025-09-19T04:27:19Z,sentiment,gpt-4.1-mini,17233,225,17458
2025-09-19T04:27:19Z,pre_sentiment,gpt-4.1-mini,291,1,292
2025-09-19T04:27:24Z,sentiment,gpt-4.1-mini,12016,314,12330
2025-09-19T04:27:24Z,pre_sentiment,gpt-4.1-mini,309,1,310
2025-09-19T04:27:28Z,sentiment,gpt-4.1-mini,4052,211,4263
2025-09-19T04:27:47Z,pre_sentiment,gpt-4.1-mini,285,1,286
2025-09-19T04:27:49Z,sentiment,gpt-4.1-mini,2220,240,2460
2025-09-19T04:27:50Z,pre_sentiment,gpt-4.1-mini,281,1,282
2025-09-19T04:27:52Z,sentiment,gpt-4.1-mini,2142,216,2358
2025-09-19T04:27:53Z,pre_sentiment,gpt-4.1-mini,283,1,284
2025-09-19T04:27:54Z,sentiment,gpt-4.1-mini,1187,155,1342
2025-09-19T04:27:55Z,pre_sentiment,gpt-4.1-mini,284,1,285
2025-09-19T04:27:57Z,sentiment,gpt-4.1-mini,2331,211,2542
2025-09-19T04:27:58Z,pre_sentiment,gpt-4.1-mini,283,1,284
2025-09-19T04:28:01Z,sentiment,gpt-4.1-mini,1445,221,1666
2025-09-19T04:28:01Z,pre_sentiment,gpt-4.1-mini,283,1,284
2025-09-19T04:28:04Z,sentiment,gpt-4.1-mini,2311,209,2520
2025-09-19T04:28:04Z,pre_sentiment,gpt-4.1-mini,281,1,282
2025-09-19T04:28:05Z,sentiment,gpt-4.1-mini,1025,128,1153
2025-09-19T04:28:06Z,pre_sentiment,gpt-4.1-mini,289,1,290
2025-09-19T04:28:08Z,sentiment,gpt-4.1-mini,1960,181,2141
2025-09-19T04:28:28Z,pre_sentiment,gpt-4.1-mini,265,1,266
2025-09-19T04:28:29Z,pre_sentiment,gpt-4.1-mini,286,1,287
2025-09-19T04:28:32Z,sentiment,gpt-4.1-mini,2690,216,2906
2025-09-19T04:28:32Z,pre_sentiment,gpt-4.1-mini,264,1,265
2025-09-19T04:28:33Z,pre_sentiment,gpt-4.1-mini,280,1,281
2025-09-19T04:28:37Z,pre_sentiment,gpt-4.1-mini,276,1,277
2025-09-19T04:28:37Z,pre_sentiment,gpt-4.1-mini,276,1,277
2025-09-19T04:28:38Z,pre_sentiment,gpt-4.1-mini,277,1,278
2025-09-19T04:28:38Z,pre_sentiment,gpt-4.1-mini,278,1,279
2025-09-19T04:28:38Z,pre_sentiment,gpt-4.1-mini,283,1,284
2025-09-19T04:28:44Z,pre_sentiment,gpt-4.1-mini,282,1,283
2025-09-19T04:28:47Z,sentiment,gpt-4.1-mini,1443,217,1660
2025-09-19T04:28:47Z,pre_sentiment,gpt-4.1-mini,283,1,284
2025-09-19T04:28:50Z,sentiment,gpt-4.1-mini,1519,171,1690
2025-09-19T04:28:50Z,pre_sentiment,gpt-4.1-mini,284,1,285
2025-09-19T04:28:53Z,sentiment,gpt-4.1-mini,1678,201,1879
2025-09-19T04:28:53Z,pre_sentiment,gpt-4.1-mini,281,1,282
2025-09-19T04:28:56Z,sentiment,gpt-4.1-mini,1555,200,1755
2025-09-19T04:28:57Z,pre_sentiment,gpt-4.1-mini,275,1,276
2025-09-19T04:28:58Z,sentiment,gpt-4.1-mini,1914,168,2082
2025-09-19T04:28:59Z,pre_sentiment,gpt-4.1-mini,287,1,288
2025-09-19T04:29:01Z,sentiment,gpt-4.1-mini,1424,212,1636
2025-09-19T04:29:08Z,pre_sentiment,gpt-4.1-mini,282,1,283
2025-09-19T04:29:10Z,sentiment,gpt-4.1-mini,1079,137,1216
2025-09-19T04:29:17Z,pre_sentiment,gpt-4.1-mini,289,1,290
2025-09-19T04:29:18Z,pre_sentiment,gpt-4.1-mini,292,1,293
2025-09-19T04:29:19Z,sentiment,gpt-4.1-mini,1263,111,1374
2025-09-19T04:29:23Z,pre_sentiment,gpt-4.1-mini,282,1,283
2025-09-19T04:29:25Z,sentiment,gpt-4.1-mini,1079,153,1232
2025-09-19T04:29:42Z,pre_sentiment,gpt-4.1-mini,287,1,288
2025-09-19T04:29:45Z,sentiment,gpt-4.1-mini,1890,173,2063
2025-09-19T04:29:46Z,pre_sentiment,gpt-4.1-mini,292,1,293
2025-09-19T04:29:48Z,sentiment,gpt-4.1-mini,1827,266,2093
2025-09-19T04:29:49Z,pre_sentiment,gpt-4.1-mini,286,1,287
2025-09-19T04:29:51Z,sentiment,gpt-4.1-mini,1907,145,2052
2025-09-19T04:29:51Z,pre_sentiment,gpt-4.1-mini,285,1,286
2025-09-19T04:29:53Z,sentiment,gpt-4.1-mini,1784,192,1976
2025-09-19T04:30:07Z,pre_sentiment,gpt-4.1-mini,288,1,289
2025-09-19T04:30:07Z,pre_sentiment,gpt-4.1-mini,283,1,284
2025-09-19T04:30:11Z,sentiment,gpt-4.1-mini,1450,232,1682
2025-09-19T04:30:12Z,pre_sentiment,gpt-4.1-mini,283,1,284
2025-09-19T04:30:12Z,pre_sentiment,gpt-4.1-mini,280,1,281
2025-09-19T04:30:15Z,sentiment,gpt-4.1-mini,1265,188,1453
2025-09-19T04:30:15Z,pre_sentiment,gpt-4.1-mini,289,1,290
2025-09-19T04:30:16Z,pre_sentiment,gpt-4.1-mini,280,1,281
2025-09-19T04:30:16Z,pre_sentiment,gpt-4.1-mini,282,1,283
2025-09-19T04:30:16Z,pre_sentiment,gpt-4.1-mini,280,1,281
2025-09-19T04:30:17Z,pre_sentiment,gpt-4.1-mini,283,1,284
2025-09-19T04:30:20Z,sentiment,gpt-4.1-mini,2184,236,2420
2025-09-19T04:30:31Z,pre_sentiment,gpt-4.1-mini,286,1,287
2025-09-19T04:30:31Z,pre_sentiment,gpt-4.1-mini,281,1,282
2025-09-19T04:30:42Z,pre_sentiment,gpt-4.1-mini,282,1,283
2025-09-19T04:30:42Z,pre_sentiment,gpt-4.1-mini,288,1,289
2025-09-19T04:30:44Z,sentiment,gpt-4.1-mini,1121,130,1251
2025-09-19T04:30:44Z,pre_sentiment,gpt-4.1-mini,289,1,290
2025-09-19T04:30:48Z,sentiment,gpt-4.1-mini,1372,191,1563
2025-09-19T04:30:48Z,pre_sentiment,gpt-4.1-mini,286,1,287
2025-09-19T04:30:51Z,sentiment,gpt-4.1-mini,1273,167,1440
2025-09-19T04:30:52Z,pre_sentiment,gpt-4.1-mini,293,1,294
2025-09-19T04:30:54Z,sentiment,gpt-4.1-mini,1307,211,1518
2025-09-19T04:30:55Z,pre_sentiment,gpt-4.1-mini,291,1,292
2025-09-19T04:30:55Z,pre_sentiment,gpt-4.1-mini,290,1,291
2025-09-19T04:30:58Z,sentiment,gpt-4.1-mini,1186,174,1360
2025-09-19T04:30:58Z,pre_sentiment,gpt-4.1-mini,278,1,279
2025-09-19T04:31:01Z,sentiment,gpt-4.1-mini,1217,132,1349
2025-09-19T04:31:01Z,pre_sentiment,gpt-4.1-mini,286,1,287
2025-09-19T04:31:04Z,sentiment,gpt-4.1-mini,1352,181,1533
2025-09-19T04:31:04Z,pre_sentiment,gpt-4.1-mini,285,1,286
2025-09-19T04:31:11Z,article_selection,gpt-4.1-mini,1570,18,1588
2025-09-19T04:31:12Z,article_selection,gpt-4.1-mini,1992,12,2004
2025-09-19T04:31:13Z,article_selection,gpt-4.1-mini,1179,12,1191
2025-09-19T04:31:13Z,article_selection,gpt-4.1-mini,736,12,748
2025-09-19T04:31:14Z,article_selection,gpt-4.1-mini,928,9,937
2025-09-19T04:31:28Z,final_summary_en,gpt-4.1-mini,1613,1014,2627
2025-09-19T04:31:49Z,final_summary_en,gpt-4.1-mini,1593,1294,2887
2025-09-19T04:32:01Z,final_summary_en,gpt-4.1-mini,1655,1006,2661
2025-09-19T04:32:20Z,final_summary_en,gpt-4.1-mini,2059,1379,3438
2025-09-19T04:32:34Z,final_summary_en,gpt-4.1-mini,3811,1089,4900
2025-09-19T04:32:44Z,final_summary_en,gpt-4.1-mini,637,785,1422
2025-09-19T04:32:54Z,final_summary_en,gpt-4.1-mini,637,841,1478
2025-09-19T04:33:15Z,final_summary_en,gpt-4.1-mini,1119,1114,2233
2025-09-19T04:33:34Z,final_summary_en,gpt-4.1-mini,1567,1193,2760
2025-09-19T04:33:51Z,final_summary_en,gpt-4.1-mini,1529,1111,2640
2025-09-19T04:34:08Z,final_summary_en,gpt-4.1-mini,1439,1167,2606
2025-09-19T04:34:22Z,final_summary_en,gpt-4.1-mini,2446,1069,3515
2025-09-19T04:34:47Z,final_summary_en,gpt-4.1-mini,1154,1141,2295
2025-09-19T04:35:03Z,final_summary_en,gpt-4.1-mini,1521,1018,2539
2025-09-19T04:35:18Z,final_summary_en,gpt-4.1-mini,1647,1131,2778
2025-09-19T04:35:37Z,final_summary_en,gpt-4.1-mini,1275,1110,2385
2025-09-19T04:35:53Z,final_summary_en,gpt-4.1-mini,1007,1134,2141
2025-09-19T04:36:11Z,final_summary_en,gpt-4.1-mini,1959,1231,3190
2025-09-19T04:36:29Z,final_summary_en,gpt-4.1-mini,1055,1166,2221
2025-09-19T04:36:40Z,final_summary_en,gpt-4.1-mini,939,965,1904
2025-09-19T04:37:42Z,category_summary,gpt-4.1-mini,125,28,153
2025-09-19T04:37:43Z,category_summary,gpt-4.1-mini,136,26,162
2025-09-19T04:37:45Z,category_summary,gpt-4.1-mini,130,34,164
2025-09-19T04:37:47Z,category_summary,gpt-4.1-mini,141,43,184
2025-09-19T04:37:50Z,category_summary,gpt-4.1-mini,129,42,171
2025-09-19T04:37:51Z,RUN_TOTAL,,191462,33068,224530
2025-09-20T04:24:44Z,pre_sentiment,gpt-4.1-mini,284,1,285
2025-09-20T04:24:45Z,pre_sentiment,gpt-4.1-mini,288,1,289
2025-09-20T04:24:48Z,sentiment,gpt-4.1-mini,1760,155,1915
2025-09-20T04:24:49Z,pre_sentiment,gpt-4.1-mini,288,1,289
2025-09-20T04:24:52Z,sentiment,gpt-4.1-mini,2437,210,2647
2025-09-20T04:24:53Z,pre_sentiment,gpt-4.1-mini,282,1,283
2025-09-20T04:24:53Z,pre_sentiment,gpt-4.1-mini,281,1,282
2025-09-20T04:24:55Z,sentiment,gpt-4.1-mini,1122,133,1255
2025-09-20T04:24:56Z,pre_sentiment,gpt-4.1-mini,282,1,283
2025-09-20T04:24:58Z,pre_sentiment,gpt-4.1-mini,283,1,284
2025-09-20T04:24:59Z,pre_sentiment,gpt-4.1-mini,290,1,291
2025-09-20T04:24:59Z,pre_sentiment,gpt-4.1-mini,281,1,282
2025-09-20T04:24:59Z,pre_sentiment,gpt-4.1-mini,281,1,282
2025-09-20T04:25:03Z,sentiment,gpt-4.1-mini,1470,248,1718
2025-09-20T04:25:04Z,pre_sentiment,gpt-4.1-mini,285,1,286
2025-09-20T04:25:04Z,pre_sentiment,gpt-4.1-mini,284,1,285
2025-09-20T04:25:08Z,sentiment,gpt-4.1-mini,1221,202,1423
2025-09-20T04:25:08Z,pre_sentiment,gpt-4.1-mini,281,1,282
2025-09-20T04:25:08Z,pre_sentiment,gpt-4.1-mini,283,1,284
2025-09-20T04:25:10Z,sentiment,gpt-4.1-mini,1406,117,1523
2025-09-20T04:25:10Z,pre_sentiment,gpt-4.1-mini,295,1,296
2025-09-20T04:25:18Z,pre_sentiment,gpt-4.1-mini,281,1,282
2025-09-20T04:25:18Z,pre_sentiment,gpt-4.1-mini,288,1,289
2025-09-20T04:25:30Z,pre_sentiment,gpt-4.1-mini,284,1,285
2025-09-20T04:25:33Z,sentiment,gpt-4.1-mini,1742,199,1941
2025-09-20T04:25:33Z,pre_sentiment,gpt-4.1-mini,286,1,287
2025-09-20T04:25:37Z,sentiment,gpt-4.1-mini,2083,216,2299
2025-09-20T04:25:37Z,pre_sentiment,gpt-4.1-mini,274,1,275
2025-09-20T04:25:38Z,pre_sentiment,gpt-4.1-mini,288,1,289
2025-09-20T04:25:41Z,sentiment,gpt-4.1-mini,1890,187,2077
2025-09-20T04:25:41Z,pre_sentiment,gpt-4.1-mini,277,1,278
2025-09-20T04:25:43Z,sentiment,gpt-4.1-mini,1523,195,1718
2025-09-20T04:25:44Z,pre_sentiment,gpt-4.1-mini,278,1,279
2025-09-20T04:25:44Z,pre_sentiment,gpt-4.1-mini,288,1,289
2025-09-20T04:25:45Z,pre_sentiment,gpt-4.1-mini,282,1,283
2025-09-20T04:25:45Z,pre_sentiment,gpt-4.1-mini,286,1,287
2025-09-20T04:25:47Z,sentiment,gpt-4.1-mini,1759,164,1923
2025-09-20T04:25:48Z,pre_sentiment,gpt-4.1-mini,284,1,285
2025-09-20T04:25:51Z,sentiment,gpt-4.1-mini,2469,200,2669
2025-09-20T04:25:51Z,pre_sentiment,gpt-4.1-mini,285,1,286
2025-09-20T04:25:51Z,pre_sentiment,gpt-4.1-mini,278,1,279
2025-09-20T04:25:55Z,sentiment,gpt-4.1-mini,1714,245,1959
2025-09-20T04:26:12Z,pre_sentiment,gpt-4.1-mini,298,1,299
2025-09-20T04:26:14Z,sentiment,gpt-4.1-mini,1768,116,1884
2025-09-20T04:26:14Z,pre_sentiment,gpt-4.1-mini,296,1,297
2025-09-20T04:26:16Z,sentiment,gpt-4.1-mini,1009,93,1102
2025-09-20T04:26:16Z,pre_sentiment,gpt-4.1-mini,303,1,304
2025-09-20T04:26:18Z,sentiment,gpt-4.1-mini,1020,97,1117
2025-09-20T04:26:18Z,pre_sentiment,gpt-4.1-mini,296,1,297
2025-09-20T04:26:20Z,sentiment,gpt-4.1-mini,1236,115,1351
2025-09-20T04:26:20Z,pre_sentiment,gpt-4.1-mini,295,1,296
2025-09-20T04:26:22Z,sentiment,gpt-4.1-mini,919,98,1017
2025-09-20T04:26:22Z,pre_sentiment,gpt-4.1-mini,299,1,300
2025-09-20T04:26:25Z,sentiment,gpt-4.1-mini,1836,179,2015
2025-09-20T04:26:25Z,pre_sentiment,gpt-4.1-mini,297,1,298
2025-09-20T04:26:27Z,sentiment,gpt-4.1-mini,1512,183,1695
2025-09-20T04:26:28Z,pre_sentiment,gpt-4.1-mini,297,1,298
2025-09-20T04:26:31Z,sentiment,gpt-4.1-mini,2212,171,2383
2025-09-20T04:26:32Z,pre_sentiment,gpt-4.1-mini,298,1,299
2025-09-20T04:26:35Z,sentiment,gpt-4.1-mini,1322,205,1527
2025-09-20T04:26:35Z,pre_sentiment,gpt-4.1-mini,295,1,296
2025-09-20T04:26:37Z,sentiment,gpt-4.1-mini,1287,184,1471
2025-09-20T04:26:38Z,pre_sentiment,gpt-4.1-mini,295,1,296
2025-09-20T04:26:38Z,pre_sentiment,gpt-4.1-mini,316,1,317
2025-09-20T04:26:40Z,sentiment,gpt-4.1-mini,974,102,1076
2025-09-20T04:26:40Z,pre_sentiment,gpt-4.1-mini,297,1,298
2025-09-20T04:26:41Z,pre_sentiment,gpt-4.1-mini,301,1,302
2025-09-20T04:26:44Z,sentiment,gpt-4.1-mini,1663,233,1896
2025-09-20T04:27:09Z,pre_sentiment,gpt-4.1-mini,274,1,275
2025-09-20T04:27:11Z,sentiment,gpt-4.1-mini,1217,180,1397
2025-09-20T04:27:12Z,pre_sentiment,gpt-4.1-mini,289,1,290
2025-09-20T04:27:14Z,sentiment,gpt-4.1-mini,1841,151,1992
2025-09-20T04:27:14Z,pre_sentiment,gpt-4.1-mini,286,1,287
2025-09-20T04:27:16Z,sentiment,gpt-4.1-mini,1183,141,1324
2025-09-20T04:27:16Z,pre_sentiment,gpt-4.1-mini,276,1,277
2025-09-20T04:27:18Z,sentiment,gpt-4.1-mini,1078,146,1224
2025-09-20T04:27:19Z,pre_sentiment,gpt-4.1-mini,289,1,290
2025-09-20T04:27:21Z,sentiment,gpt-4.1-mini,1367,168,1535
2025-09-20T04:27:29Z,pre_sentiment,gpt-4.1-mini,286,1,287
2025-09-20T04:27:31Z,sentiment,gpt-4.1-mini,943,143,1086
2025-09-20T04:27:35Z,pre_sentiment,gpt-4.1-mini,285,1,286
2025-09-20T04:27:40Z,pre_sentiment,gpt-4.1-mini,275,1,276
2025-09-20T04:27:42Z,sentiment,gpt-4.1-mini,2006,211,2217
2025-09-20T04:27:42Z,pre_sentiment,gpt-4.1-mini,272,1,273
2025-09-20T04:27:45Z,sentiment,gpt-4.1-mini,1748,215,1963
2025-09-20T04:27:46Z,pre_sentiment,gpt-4.1-mini,275,1,276
2025-09-20T04:27:48Z,sentiment,gpt-4.1-mini,1736,228,1964
2025-09-20T04:27:49Z,pre_sentiment,gpt-4.1-mini,279,1,280
2025-09-20T04:27:49Z,pre_sentiment,gpt-4.1-mini,276,1,277
2025-09-20T04:28:04Z,pre_sentiment,gpt-4.1-mini,287,1,288
2025-09-20T04:28:06Z,sentiment,gpt-4.1-mini,1542,205,1747
2025-09-20T04:28:07Z,pre_sentiment,gpt-4.1-mini,288,1,289
2025-09-20T04:28:09Z,sentiment,gpt-4.1-mini,1834,222,2056
2025-09-20T04:28:10Z,pre_sentiment,gpt-4.1-mini,281,1,282
2025-09-20T04:28:10Z,pre_sentiment,gpt-4.1-mini,286,1,287
2025-09-20T04:28:13Z,sentiment,gpt-4.1-mini,1546,181,1727
2025-09-20T04:28:14Z,pre_sentiment,gpt-4.1-mini,277,1,278
2025-09-20T04:28:17Z,sentiment,gpt-4.1-mini,1769,227,1996
2025-09-20T04:28:25Z,pre_sentiment,gpt-4.1-mini,283,1,284
2025-09-20T04:28:28Z,sentiment,gpt-4.1-mini,1545,237,1782
2025-09-20T04:28:34Z,pre_sentiment,gpt-4.1-mini,286,1,287
2025-09-20T04:28:36Z,sentiment,gpt-4.1-mini,1122,170,1292
2025-09-20T04:28:57Z,pre_sentiment,gpt-4.1-mini,297,1,298
2025-09-20T04:29:00Z,sentiment,gpt-4.1-mini,6496,208,6704
2025-09-20T04:29:00Z,pre_sentiment,gpt-4.1-mini,287,1,288
2025-09-20T04:29:03Z,sentiment,gpt-4.1-mini,1890,189,2079
2025-09-20T04:29:29Z,pre_sentiment,gpt-4.1-mini,282,1,283
2025-09-20T04:29:29Z,pre_sentiment,gpt-4.1-mini,292,1,293
2025-09-20T04:29:31Z,sentiment,gpt-4.1-mini,1361,147,1508
2025-09-20T04:29:32Z,pre_sentiment,gpt-4.1-mini,276,1,277
2025-09-20T04:29:32Z,pre_sentiment,gpt-4.1-mini,284,1,285
2025-09-20T04:29:32Z,pre_sentiment,gpt-4.1-mini,282,1,283
2025-09-20T04:29:33Z,pre_sentiment,gpt-4.1-mini,286,1,287
2025-09-20T04:29:33Z,pre_sentiment,gpt-4.1-mini,286,1,287
2025-09-20T04:29:34Z,pre_sentiment,gpt-4.1-mini,287,1,288
2025-09-20T04:29:50Z,pre_sentiment,gpt-4.1-mini,280,1,281
2025-09-20T04:29:53Z,sentiment,gpt-4.1-mini,2317,228,2545
2025-09-20T04:29:53Z,pre_sentiment,gpt-4.1-mini,291,1,292
2025-09-20T04:29:56Z,sentiment,gpt-4.1-mini,3654,247,3901
2025-09-20T04:30:11Z,pre_sentiment,gpt-4.1-mini,279,1,280
2025-09-20T04:30:11Z,pre_sentiment,gpt-4.1-mini,297,1,298
2025-09-20T04:30:14Z,sentiment,gpt-4.1-mini,1465,195,1660
2025-09-20T04:30:15Z,pre_sentiment,gpt-4.1-mini,289,1,290
2025-09-20T04:30:17Z,sentiment,gpt-4.1-mini,1321,189,1510
2025-09-20T04:30:17Z,pre_sentiment,gpt-4.1-mini,278,1,279
2025-09-20T04:30:20Z,sentiment,gpt-4.1-mini,1274,195,1469
2025-09-20T04:30:21Z,pre_sentiment,gpt-4.1-mini,286,1,287
2025-09-20T04:30:21Z,pre_sentiment,gpt-4.1-mini,293,1,294
2025-09-20T04:30:24Z,sentiment,gpt-4.1-mini,1460,185,1645
2025-09-20T04:30:24Z,pre_sentiment,gpt-4.1-mini,289,1,290
2025-09-20T04:30:24Z,pre_sentiment,gpt-4.1-mini,278,1,279
2025-09-20T04:30:25Z,pre_sentiment,gpt-4.1-mini,282,1,283
2025-09-20T04:30:27Z,sentiment,gpt-4.1-mini,1114,180,1294
2025-09-20T04:30:27Z,pre_sentiment,gpt-4.1-mini,287,1,288
2025-09-20T04:30:29Z,pre_sentiment,gpt-4.1-mini,290,1,291
2025-09-20T04:30:30Z,pre_sentiment,gpt-4.1-mini,301,1,302
2025-09-20T04:30:32Z,sentiment,gpt-4.1-mini,1353,153,1506
2025-09-20T04:30:32Z,pre_sentiment,gpt-4.1-mini,279,1,280
2025-09-20T04:30:33Z,pre_sentiment,gpt-4.1-mini,290,1,291
2025-09-20T04:30:33Z,pre_sentiment,gpt-4.1-mini,290,1,291
2025-09-20T04:30:43Z,article_selection,gpt-4.1-mini,970,12,982
2025-09-20T04:30:43Z,article_selection,gpt-4.1-mini,1205,9,1214
2025-09-20T04:30:44Z,article_selection,gpt-4.1-mini,3041,12,3053
2025-09-20T04:30:44Z,article_selection,gpt-4.1-mini,882,12,894
2025-09-20T04:30:45Z,article_selection,gpt-4.1-mini,479,5,484
2025-09-20T04:30:46Z,article_selection,gpt-4.1-mini,472,6,478
2025-09-20T04:30:56Z,final_summary_en,gpt-4.1-mini,1242,993,2235
2025-09-20T04:31:08Z,final_summary_en,gpt-4.1-mini,1636,1130,2766
2025-09-20T04:31:18Z,final_summary_en,gpt-4.1-mini,1079,1000,2079
2025-09-20T04:31:32Z,final_summary_en,gpt-4.1-mini,1029,1130,2159
2025-09-20T04:31:44Z,final_summary_en,gpt-4.1-mini,1486,1148,2634
2025-09-20T04:31:53Z,final_summary_en,gpt-4.1-mini,1267,937,2204
2025-09-20T04:32:03Z,final_summary_en,gpt-4.1-mini,1257,1063,2320
2025-09-20T04:32:21Z,final_summary_en,gpt-4.1-mini,1447,965,2412
2025-09-20T04:32:28Z,final_summary_en,gpt-4.1-mini,1927,1040,2967
2025-09-20T04:32:44Z,final_summary_en,gpt-4.1-mini,1509,1119,2628
2025-09-20T04:33:03Z,final_summary_en,gpt-4.1-mini,6254,1348,7602
2025-09-20T04:33:19Z,final_summary_en,gpt-4.1-mini,3444,1158,4602
2025-09-20T04:33:32Z,final_summary_en,gpt-4.1-mini,1034,969,2003
2025-09-20T04:33:53Z,final_summary_en,gpt-4.1-mini,1311,1422,2733
2025-09-20T04:34:07Z,final_summary_en,gpt-4.1-mini,1545,1146,2691
2025-09-20T04:34:20Z,final_summary_en,gpt-4.1-mini,1191,1083,2274
2025-09-20T04:34:34Z,final_summary_en,gpt-4.1-mini,986,1104,2090
2025-09-20T04:34:45Z,final_summary_en,gpt-4.1-mini,870,872,1742
2025-09-20T04:35:00Z,final_summary_en,gpt-4.1-mini,1489,1160,2649
2025-09-20T04:35:16Z,final_summary_en,gpt-4.1-mini,955,1076,2031
2025-09-20T04:36:25Z,category_summary,gpt-4.1-mini,131,31,162
2025-09-20T04:36:27Z,category_summary,gpt-4.1-mini,133,30,163
2025-09-20T04:36:29Z,category_summary,gpt-4.1-mini,133,37,170
2025-09-20T04:36:32Z,category_summary,gpt-4.1-mini,149,42,191
2025-09-20T04:36:34Z,category_summary,gpt-4.1-mini,91,22,113
2025-09-20T04:36:36Z,category_summary,gpt-4.1-mini,99,27,126
2025-09-20T04:36:37Z,RUN_TOTAL,,151777,31385,183162
2025-09-21T04:24:27Z,pre_sentiment,gpt-4.1-mini,284,1,285
2025-09-21T04:24:27Z,pre_sentiment,gpt-4.1-mini,285,1,286
2025-09-21T04:24:28Z,pre_sentiment,gpt-4.1-mini,277,1,278
2025-09-21T04:24:29Z,pre_sentiment,gpt-4.1-mini,287,1,288
2025-09-21T04:24:29Z,pre_sentiment,gpt-4.1-mini,279,1,280
2025-09-21T04:24:30Z,pre_sentiment,gpt-4.1-mini,281,1,282
2025-09-21T04:24:30Z,pre_sentiment,gpt-4.1-mini,284,1,285
2025-09-21T04:24:31Z,pre_sentiment,gpt-4.1-mini,286,1,287
2025-09-21T04:24:34Z,sentiment,gpt-4.1-mini,1837,193,2030
2025-09-21T04:24:34Z,pre_sentiment,gpt-4.1-mini,287,1,288
2025-09-21T04:24:35Z,pre_sentiment,gpt-4.1-mini,288,1,289
2025-09-21T04:24:35Z,pre_sentiment,gpt-4.1-mini,284,1,285
2025-09-21T04:24:35Z,pre_sentiment,gpt-4.1-mini,299,1,300
2025-09-21T04:24:36Z,pre_sentiment,gpt-4.1-mini,290,1,291
2025-09-21T04:24:39Z,sentiment,gpt-4.1-mini,2176,177,2353
2025-09-21T04:24:39Z,pre_sentiment,gpt-4.1-mini,277,1,278
2025-09-21T04:24:46Z,pre_sentiment,gpt-4.1-mini,281,1,282
2025-09-21T04:24:57Z,pre_sentiment,gpt-4.1-mini,281,1,282
2025-09-21T04:25:00Z,sentiment,gpt-4.1-mini,1593,211,1804
2025-09-21T04:25:00Z,pre_sentiment,gpt-4.1-mini,278,1,279
2025-09-21T04:25:02Z,sentiment,gpt-4.1-mini,1782,179,1961
2025-09-21T04:25:03Z,pre_sentiment,gpt-4.1-mini,280,1,281
2025-09-21T04:25:06Z,sentiment,gpt-4.1-mini,1924,202,2126
2025-09-21T04:25:06Z,pre_sentiment,gpt-4.1-mini,282,1,283
2025-09-21T04:25:09Z,sentiment,gpt-4.1-mini,2012,195,2207
2025-09-21T04:25:09Z,pre_sentiment,gpt-4.1-mini,282,1,283
2025-09-21T04:25:11Z,sentiment,gpt-4.1-mini,1324,188,1512
2025-09-21T04:25:12Z,pre_sentiment,gpt-4.1-mini,280,1,281
2025-09-21T04:25:14Z,sentiment,gpt-4.1-mini,1410,189,1599
2025-09-21T04:25:14Z,pre_sentiment,gpt-4.1-mini,279,1,280
2025-09-21T04:25:19Z,sentiment,gpt-4.1-mini,1675,189,1864
2025-09-21T04:25:19Z,pre_sentiment,gpt-4.1-mini,278,1,279
2025-09-21T04:25:23Z,sentiment,gpt-4.1-mini,1856,220,2076
2025-09-21T04:25:24Z,pre_sentiment,gpt-4.1-mini,276,1,277
2025-09-21T04:25:28Z,sentiment,gpt-4.1-mini,1850,197,2047
2025-09-21T04:25:28Z,pre_sentiment,gpt-4.1-mini,273,1,274
2025-09-21T04:25:31Z,sentiment,gpt-4.1-mini,1992,248,2240
2025-09-21T04:25:31Z,pre_sentiment,gpt-4.1-mini,278,1,279
2025-09-21T04:25:31Z,pre_sentiment,gpt-4.1-mini,280,1,281
2025-09-21T04:25:35Z,sentiment,gpt-4.1-mini,2295,232,2527
2025-09-21T04:25:35Z,pre_sentiment,gpt-4.1-mini,286,1,287
2025-09-21T04:25:39Z,sentiment,gpt-4.1-mini,2083,186,2269
2025-09-21T04:25:53Z,pre_sentiment,gpt-4.1-mini,298,1,299
2025-09-21T04:25:55Z,sentiment,gpt-4.1-mini,1768,128,1896
2025-09-21T04:25:56Z,pre_sentiment,gpt-4.1-mini,296,1,297
2025-09-21T04:25:57Z,sentiment,gpt-4.1-mini,1009,85,1094
2025-09-21T04:25:57Z,pre_sentiment,gpt-4.1-mini,303,1,304
2025-09-21T04:25:58Z,pre_sentiment,gpt-4.1-mini,296,1,297
2025-09-21T04:26:00Z,sentiment,gpt-4.1-mini,1236,128,1364
2025-09-21T04:26:00Z,pre_sentiment,gpt-4.1-mini,295,1,296
2025-09-21T04:26:02Z,sentiment,gpt-4.1-mini,919,123,1042
2025-09-21T04:26:03Z,pre_sentiment,gpt-4.1-mini,299,1,300
2025-09-21T04:26:05Z,sentiment,gpt-4.1-mini,1836,168,2004
2025-09-21T04:26:05Z,pre_sentiment,gpt-4.1-mini,298,1,299
2025-09-21T04:26:08Z,sentiment,gpt-4.1-mini,1322,193,1515
2025-09-21T04:26:08Z,pre_sentiment,gpt-4.1-mini,295,1,296
2025-09-21T04:26:09Z,pre_sentiment,gpt-4.1-mini,316,1,317
2025-09-21T04:26:11Z,sentiment,gpt-4.1-mini,974,117,1091
2025-09-21T04:26:11Z,pre_sentiment,gpt-4.1-mini,297,1,298
2025-09-21T04:26:23Z,pre_sentiment,gpt-4.1-mini,277,1,278
2025-09-21T04:26:27Z,sentiment,gpt-4.1-mini,1491,268,1759
2025-09-21T04:26:39Z,pre_sentiment,gpt-4.1-mini,267,1,268
2025-09-21T04:27:41Z,pre_sentiment,gpt-4.1-mini,286,1,287
2025-09-21T04:27:43Z,sentiment,gpt-4.1-mini,2030,142,2172
2025-09-21T04:27:43Z,pre_sentiment,gpt-4.1-mini,281,1,282
2025-09-21T04:27:45Z,sentiment,gpt-4.1-mini,1946,177,2123
2025-09-21T04:27:46Z,pre_sentiment,gpt-4.1-mini,300,1,301
2025-09-21T04:28:11Z,article_selection,gpt-4.1-mini,564,9,573
2025-09-21T04:28:12Z,article_selection,gpt-4.1-mini,1145,16,1161
2025-09-21T04:28:13Z,article_selection,gpt-4.1-mini,703,12,715
2025-09-21T04:28:13Z,article_selection,gpt-4.1-mini,405,5,410
2025-09-21T04:28:26Z,final_summary_en,gpt-4.1-mini,1267,1101,2368
2025-09-21T04:28:39Z,final_summary_en,gpt-4.1-mini,1522,1004,2526
2025-09-21T04:28:54Z,final_summary_en,gpt-4.1-mini,1607,1293,2900
2025-09-21T04:29:10Z,final_summary_en,gpt-4.1-mini,1356,1072,2428
2025-09-21T04:29:24Z,final_summary_en,gpt-4.1-mini,1420,1028,2448
2025-09-21T04:29:35Z,final_summary_en,gpt-4.1-mini,1601,878,2479
2025-09-21T04:29:47Z,final_summary_en,gpt-4.1-mini,1151,976,2127
2025-09-21T04:30:03Z,final_summary_en,gpt-4.1-mini,1783,1294,3077
2025-09-21T04:30:23Z,final_summary_en,gpt-4.1-mini,1672,1284,2956
2025-09-21T04:30:41Z,final_summary_en,gpt-4.1-mini,1756,1125,2881
2025-09-21T04:30:56Z,final_summary_en,gpt-4.1-mini,1829,1052,2881
2025-09-21T04:31:09Z,final_summary_en,gpt-4.1-mini,1577,951,2528
2025-09-21T04:31:27Z,final_summary_en,gpt-4.1-mini,1695,1143,2838
2025-09-21T04:32:06Z,category_summary,gpt-4.1-mini,117,43,160
2025-09-21T04:32:08Z,category_summary,gpt-4.1-mini,104,42,146
2025-09-21T04:32:10Z,category_summary,gpt-4.1-mini,118,26,144
2025-09-21T04:32:12Z,category_summary,gpt-4.1-mini,105,21,126
2025-09-21T04:32:13Z,RUN_TOTAL,,76143,18753,94896
2025-09-22T04:25:28Z,pre_sentiment,gpt-4.1-mini,275,1,276
2025-09-22T04:25:32Z,sentiment,gpt-4.1-mini,2218,186,2404
2025-09-22T04:25:33Z,pre_sentiment,gpt-4.1-mini,289,1,290
2025-09-22T04:25:34Z,pre_sentiment,gpt-4.1-mini,277,1,278
2025-09-22T04:25:35Z,pre_sentiment,gpt-4.1-mini,275,1,276
2025-09-22T04:25:38Z,sentiment,gpt-4.1-mini,1787,163,1950
2025-09-22T04:25:38Z,pre_sentiment,gpt-4.1-mini,285,1,286
2025-09-22T04:25:38Z,pre_sentiment,gpt-4.1-mini,289,1,290
2025-09-22T04:25:39Z,pre_sentiment,gpt-4.1-mini,292,1,293
2025-09-22T04:25:39Z,pre_sentiment,gpt-4.1-mini,288,1,289
2025-09-22T04:25:40Z,pre_sentiment,gpt-4.1-mini,280,1,281
2025-09-22T04:25:43Z,sentiment,gpt-4.1-mini,1635,176,1811
2025-09-22T04:25:43Z,pre_sentiment,gpt-4.1-mini,285,1,286
2025-09-22T04:25:44Z,pre_sentiment,gpt-4.1-mini,284,1,285
2025-09-22T04:25:45Z,pre_sentiment,gpt-4.1-mini,288,1,289
2025-09-22T04:25:45Z,pre_sentiment,gpt-4.1-mini,281,1,282
2025-09-22T04:26:03Z,pre_sentiment,gpt-4.1-mini,282,1,283
2025-09-22T04:26:06Z,sentiment,gpt-4.1-mini,2269,216,2485
2025-09-22T04:26:06Z,pre_sentiment,gpt-4.1-mini,278,1,279
2025-09-22T04:26:09Z,sentiment,gpt-4.1-mini,1608,174,1782
2025-09-22T04:26:09Z,pre_sentiment,gpt-4.1-mini,286,1,287
2025-09-22T04:26:12Z,sentiment,gpt-4.1-mini,2215,221,2436
2025-09-22T04:26:12Z,pre_sentiment,gpt-4.1-mini,281,1,282
2025-09-22T04:26:16Z,sentiment,gpt-4.1-mini,1479,236,1715
2025-09-22T04:26:16Z,pre_sentiment,gpt-4.1-mini,284,1,285
2025-09-22T04:26:20Z,sentiment,gpt-4.1-mini,1435,189,1624
2025-09-22T04:26:20Z,pre_sentiment,gpt-4.1-mini,282,1,283
2025-09-22T04:26:24Z,sentiment,gpt-4.1-mini,1874,198,2072
2025-09-22T04:26:24Z,pre_sentiment,gpt-4.1-mini,279,1,280
2025-09-22T04:26:27Z,sentiment,gpt-4.1-mini,1719,213,1932
2025-09-22T04:26:28Z,pre_sentiment,gpt-4.1-mini,277,1,278
2025-09-22T04:26:31Z,sentiment,gpt-4.1-mini,1522,195,1717
2025-09-22T04:26:31Z,pre_sentiment,gpt-4.1-mini,283,1,284
2025-09-22T04:26:34Z,sentiment,gpt-4.1-mini,2040,202,2242
2025-09-22T04:26:34Z,pre_sentiment,gpt-4.1-mini,290,1,291
2025-09-22T04:26:38Z,sentiment,gpt-4.1-mini,2184,227,2411
2025-09-22T04:26:38Z,pre_sentiment,gpt-4.1-mini,281,1,282
2025-09-22T04:26:41Z,sentiment,gpt-4.1-mini,2055,195,2250
2025-09-22T04:26:58Z,pre_sentiment,gpt-4.1-mini,298,1,299
2025-09-22T04:27:01Z,sentiment,gpt-4.1-mini,1768,136,1904
2025-09-22T04:27:02Z,pre_sentiment,gpt-4.1-mini,296,1,297
2025-09-22T04:27:04Z,sentiment,gpt-4.1-mini,1009,91,1100
2025-09-22T04:27:04Z,pre_sentiment,gpt-4.1-mini,303,1,304
2025-09-22T04:27:06Z,sentiment,gpt-4.1-mini,1020,93,1113
2025-09-22T04:27:06Z,pre_sentiment,gpt-4.1-mini,296,1,297
2025-09-22T04:27:09Z,sentiment,gpt-4.1-mini,1236,138,1374
2025-09-22T04:27:10Z,pre_sentiment,gpt-4.1-mini,295,1,296
2025-09-22T04:27:12Z,sentiment,gpt-4.1-mini,919,125,1044
2025-09-22T04:27:12Z,pre_sentiment,gpt-4.1-mini,298,1,299
2025-09-22T04:27:17Z,sentiment,gpt-4.1-mini,1322,171,1493
2025-09-22T04:27:17Z,pre_sentiment,gpt-4.1-mini,295,1,296
2025-09-22T04:27:18Z,pre_sentiment,gpt-4.1-mini,316,1,317
2025-09-22T04:27:20Z,sentiment,gpt-4.1-mini,974,92,1066
2025-09-22T04:27:20Z,pre_sentiment,gpt-4.1-mini,297,1,298
2025-09-22T04:27:50Z,pre_sentiment,gpt-4.1-mini,263,1,264
2025-09-22T04:27:54Z,sentiment,gpt-4.1-mini,3531,228,3759
2025-09-22T04:27:58Z,pre_sentiment,gpt-4.1-mini,275,1,276
2025-09-22T04:28:33Z,pre_sentiment,gpt-4.1-mini,288,1,289
2025-09-22T04:29:05Z,pre_sentiment,gpt-4.1-mini,289,1,290
2025-09-22T04:29:07Z,sentiment,gpt-4.1-mini,1562,223,1785
2025-09-22T04:29:24Z,pre_sentiment,gpt-4.1-mini,289,1,290
2025-09-22T04:29:27Z,sentiment,gpt-4.1-mini,1559,235,1794
2025-09-22T04:29:27Z,pre_sentiment,gpt-4.1-mini,290,1,291
2025-09-22T04:29:30Z,sentiment,gpt-4.1-mini,1214,175,1389
2025-09-22T04:29:30Z,pre_sentiment,gpt-4.1-mini,287,1,288
2025-09-22T04:29:31Z,pre_sentiment,gpt-4.1-mini,282,1,283
2025-09-22T04:29:44Z,pre_sentiment,gpt-4.1-mini,293,1,294
2025-09-22T04:29:44Z,pre_sentiment,gpt-4.1-mini,295,1,296
2025-09-22T04:29:48Z,sentiment,gpt-4.1-mini,2645,214,2859
2025-09-22T04:30:09Z,article_selection,gpt-4.1-mini,993,12,1005
2025-09-22T04:30:10Z,article_selection,gpt-4.1-mini,757,16,773
2025-09-22T04:30:10Z,article_selection,gpt-4.1-mini,432,5,437
2025-09-22T04:30:11Z,article_selection,gpt-4.1-mini,641,16,657
2025-09-22T04:30:33Z,final_summary_en,gpt-4.1-mini,2042,1168,3210
2025-09-22T04:30:48Z,final_summary_en,gpt-4.1-mini,1253,1043,2296
2025-09-22T04:31:04Z,final_summary_en,gpt-4.1-mini,1617,1046,2663
2025-09-22T04:31:16Z,final_summary_en,gpt-4.1-mini,1475,938,2413
2025-09-22T04:31:32Z,final_summary_en,gpt-4.1-mini,1971,1202,3173
2025-09-22T04:31:50Z,final_summary_en,gpt-4.1-mini,1793,1243,3036
2025-09-22T04:32:08Z,final_summary_en,gpt-4.1-mini,1954,1153,3107
2025-09-22T04:32:26Z,final_summary_en,gpt-4.1-mini,1195,1085,2280
2025-09-22T04:32:40Z,final_summary_en,gpt-4.1-mini,1804,1099,2903
2025-09-22T04:32:54Z,final_summary_en,gpt-4.1-mini,1349,888,2237
2025-09-22T04:33:10Z,final_summary_en,gpt-4.1-mini,3298,1220,4518
2025-09-22T04:33:30Z,final_summary_en,gpt-4.1-mini,1327,1137,2464
2025-09-22T04:33:49Z,final_summary_en,gpt-4.1-mini,1324,1281,2605
2025-09-22T04:34:07Z,final_summary_en,gpt-4.1-mini,1983,1287,3270
2025-09-22T04:34:24Z,final_summary_en,gpt-4.1-mini,962,1121,2083
2025-09-22T04:34:41Z,final_summary_en,gpt-4.1-mini,2394,1317,3711
2025-09-22T04:35:37Z,category_summary,gpt-4.1-mini,124,32,156
2025-09-22T04:35:39Z,category_summary,gpt-4.1-mini,85,23,108
2025-09-22T04:35:41Z,category_summary,gpt-4.1-mini,95,28,123
2025-09-22T04:35:43Z,category_summary,gpt-4.1-mini,140,34,174
2025-09-22T04:35:45Z,category_summary,gpt-4.1-mini,132,41,173
2025-09-22T04:35:47Z,category_summary,gpt-4.1-mini,86,20,106
2025-09-22T04:35:49Z,RUN_TOTAL,,88361,23210,111571
2025-09-23T04:25:16Z,pre_sentiment,gpt-4.1-mini,283,1,284
2025-09-23T04:25:17Z,pre_sentiment,gpt-4.1-mini,285,1,286
2025-09-23T04:25:17Z,pre_sentiment,gpt-4.1-mini,286,1,287
2025-09-23T04:25:20Z,pre_sentiment,gpt-4.1-mini,279,1,280
2025-09-23T04:25:24Z,sentiment,gpt-4.1-mini,1548,188,1736
2025-09-23T04:25:25Z,pre_sentiment,gpt-4.1-mini,285,1,286
2025-09-23T04:25:25Z,pre_sentiment,gpt-4.1-mini,282,1,283
2025-09-23T04:25:28Z,sentiment,gpt-4.1-mini,1675,166,1841
2025-09-23T04:25:28Z,pre_sentiment,gpt-4.1-mini,282,1,283
2025-09-23T04:25:31Z,sentiment,gpt-4.1-mini,1321,150,1471
2025-09-23T04:25:32Z,pre_sentiment,gpt-4.1-mini,284,1,285
2025-09-23T04:25:33Z,pre_sentiment,gpt-4.1-mini,285,1,286
2025-09-23T04:25:33Z,pre_sentiment,gpt-4.1-mini,275,1,276
2025-09-23T04:25:33Z,pre_sentiment,gpt-4.1-mini,285,1,286
2025-09-23T04:25:34Z,pre_sentiment,gpt-4.1-mini,281,1,282
2025-09-23T04:25:35Z,pre_sentiment,gpt-4.1-mini,277,1,278
2025-09-23T04:25:35Z,pre_sentiment,gpt-4.1-mini,283,1,284
2025-09-23T04:25:43Z,pre_sentiment,gpt-4.1-mini,285,1,286
2025-09-23T04:25:45Z,sentiment,gpt-4.1-mini,1217,150,1367
2025-09-23T04:25:46Z,pre_sentiment,gpt-4.1-mini,277,1,278
2025-09-23T04:25:46Z,pre_sentiment,gpt-4.1-mini,278,1,279
2025-09-23T04:25:59Z,pre_sentiment,gpt-4.1-mini,283,1,284
2025-09-23T04:25:59Z,pre_sentiment,gpt-4.1-mini,292,1,293
2025-09-23T04:26:02Z,sentiment,gpt-4.1-mini,1856,199,2055
2025-09-23T04:26:02Z,pre_sentiment,gpt-4.1-mini,277,1,278
2025-09-23T04:26:05Z,sentiment,gpt-4.1-mini,1302,179,1481
2025-09-23T04:26:06Z,pre_sentiment,gpt-4.1-mini,284,1,285
2025-09-23T04:26:09Z,sentiment,gpt-4.1-mini,1819,201,2020
2025-09-23T04:26:09Z,pre_sentiment,gpt-4.1-mini,282,1,283
2025-09-23T04:26:13Z,sentiment,gpt-4.1-mini,1776,242,2018
2025-09-23T04:26:13Z,pre_sentiment,gpt-4.1-mini,281,1,282
2025-09-23T04:26:13Z,pre_sentiment,gpt-4.1-mini,283,1,284
2025-09-23T04:26:16Z,sentiment,gpt-4.1-mini,1312,162,1474
2025-09-23T04:26:16Z,pre_sentiment,gpt-4.1-mini,286,1,287
2025-09-23T04:26:16Z,pre_sentiment,gpt-4.1-mini,285,1,286
2025-09-23T04:26:19Z,sentiment,gpt-4.1-mini,1591,193,1784
2025-09-23T04:26:19Z,pre_sentiment,gpt-4.1-mini,285,1,286
2025-09-23T04:26:28Z,sentiment,gpt-4.1-mini,1638,187,1825
2025-09-23T04:26:47Z,pre_sentiment,gpt-4.1-mini,300,1,301
2025-09-23T04:26:49Z,sentiment,gpt-4.1-mini,1089,144,1233
2025-09-23T04:26:49Z,pre_sentiment,gpt-4.1-mini,306,1,307
2025-09-23T04:26:51Z,sentiment,gpt-4.1-mini,1062,97,1159
2025-09-23T04:26:51Z,pre_sentiment,gpt-4.1-mini,302,1,303
2025-09-23T04:26:52Z,pre_sentiment,gpt-4.1-mini,298,1,299
2025-09-23T04:26:54Z,sentiment,gpt-4.1-mini,968,172,1140
2025-09-23T04:26:54Z,pre_sentiment,gpt-4.1-mini,296,1,297
2025-09-23T04:26:57Z,sentiment,gpt-4.1-mini,1110,163,1273
2025-09-23T04:26:58Z,pre_sentiment,gpt-4.1-mini,302,1,303
2025-09-23T04:27:00Z,sentiment,gpt-4.1-mini,1270,159,1429
2025-09-23T04:27:00Z,pre_sentiment,gpt-4.1-mini,297,1,298
2025-09-23T04:27:03Z,sentiment,gpt-4.1-mini,1442,155,1597
2025-09-23T04:27:03Z,pre_sentiment,gpt-4.1-mini,298,1,299
2025-09-23T04:27:04Z,pre_sentiment,gpt-4.1-mini,296,1,297
2025-09-23T04:27:07Z,sentiment,gpt-4.1-mini,3091,222,3313
2025-09-23T04:27:08Z,pre_sentiment,gpt-4.1-mini,298,1,299
2025-09-23T04:27:08Z,pre_sentiment,gpt-4.1-mini,298,1,299
2025-09-23T04:27:10Z,sentiment,gpt-4.1-mini,1768,133,1901
2025-09-23T04:27:11Z,pre_sentiment,gpt-4.1-mini,296,1,297
2025-09-23T04:27:12Z,sentiment,gpt-4.1-mini,1009,87,1096
2025-09-23T04:27:12Z,pre_sentiment,gpt-4.1-mini,303,1,304
2025-09-23T04:27:14Z,sentiment,gpt-4.1-mini,1020,85,1105
2025-09-23T04:27:14Z,pre_sentiment,gpt-4.1-mini,296,1,297
2025-09-23T04:27:16Z,sentiment,gpt-4.1-mini,1236,117,1353
2025-09-23T04:27:17Z,pre_sentiment,gpt-4.1-mini,295,1,296
2025-09-23T04:27:19Z,sentiment,gpt-4.1-mini,919,125,1044
2025-09-23T04:27:34Z,pre_sentiment,gpt-4.1-mini,284,1,285
2025-09-23T04:27:38Z,sentiment,gpt-4.1-mini,1473,233,1706
2025-09-23T04:27:39Z,pre_sentiment,gpt-4.1-mini,274,1,275
2025-09-23T04:27:41Z,sentiment,gpt-4.1-mini,1094,124,1218
2025-09-23T04:27:41Z,pre_sentiment,gpt-4.1-mini,292,1,293
2025-09-23T04:27:43Z,sentiment,gpt-4.1-mini,916,109,1025
2025-09-23T04:27:43Z,pre_sentiment,gpt-4.1-mini,286,1,287
2025-09-23T04:27:46Z,sentiment,gpt-4.1-mini,2955,173,3128
2025-09-23T04:27:51Z,pre_sentiment,gpt-4.1-mini,291,1,292
2025-09-23T04:27:54Z,sentiment,gpt-4.1-mini,2726,196,2922
2025-09-23T04:27:54Z,pre_sentiment,gpt-4.1-mini,284,1,285
2025-09-23T04:27:57Z,sentiment,gpt-4.1-mini,1258,177,1435
2025-09-23T04:28:01Z,pre_sentiment,gpt-4.1-mini,280,1,281
2025-09-23T04:28:07Z,pre_sentiment,gpt-4.1-mini,278,1,279
2025-09-23T04:28:07Z,pre_sentiment,gpt-4.1-mini,275,1,276
2025-09-23T04:28:08Z,pre_sentiment,gpt-4.1-mini,275,1,276
2025-09-23T04:28:08Z,pre_sentiment,gpt-4.1-mini,275,1,276
2025-09-23T04:28:08Z,pre_sentiment,gpt-4.1-mini,274,1,275
2025-09-23T04:28:09Z,pre_sentiment,gpt-4.1-mini,279,1,280
2025-09-23T04:28:11Z,sentiment,gpt-4.1-mini,1345,151,1496
2025-09-23T04:28:11Z,pre_sentiment,gpt-4.1-mini,279,1,280
2025-09-23T04:28:14Z,sentiment,gpt-4.1-mini,1955,213,2168
2025-09-23T04:28:15Z,pre_sentiment,gpt-4.1-mini,277,1,278
2025-09-23T04:28:15Z,pre_sentiment,gpt-4.1-mini,275,1,276
2025-09-23T04:28:30Z,pre_sentiment,gpt-4.1-mini,279,1,280
2025-09-23T04:28:32Z,sentiment,gpt-4.1-mini,1423,161,1584
2025-09-23T04:28:32Z,pre_sentiment,gpt-4.1-mini,283,1,284
2025-09-23T04:28:36Z,sentiment,gpt-4.1-mini,3898,231,4129
2025-09-23T04:28:37Z,pre_sentiment,gpt-4.1-mini,285,1,286
2025-09-23T04:28:38Z,pre_sentiment,gpt-4.1-mini,281,1,282
2025-09-23T04:28:40Z,sentiment,gpt-4.1-mini,1991,153,2144
2025-09-23T04:28:54Z,pre_sentiment,gpt-4.1-mini,282,1,283
2025-09-23T04:28:56Z,sentiment,gpt-4.1-mini,1100,126,1226
2025-09-23T04:28:56Z,pre_sentiment,gpt-4.1-mini,291,1,292
2025-09-23T04:29:07Z,pre_sentiment,gpt-4.1-mini,298,1,299
2025-09-23T04:29:09Z,sentiment,gpt-4.1-mini,1173,122,1295
2025-09-23T04:29:13Z,pre_sentiment,gpt-4.1-mini,282,1,283
2025-09-23T04:29:15Z,sentiment,gpt-4.1-mini,1100,135,1235
2025-09-23T04:29:16Z,pre_sentiment,gpt-4.1-mini,291,1,292
2025-09-23T04:29:39Z,pre_sentiment,gpt-4.1-mini,286,1,287
2025-09-23T04:29:44Z,sentiment,gpt-4.1-mini,1626,202,1828
2025-09-23T04:29:45Z,pre_sentiment,gpt-4.1-mini,286,1,287
2025-09-23T04:29:48Z,sentiment,gpt-4.1-mini,1754,201,1955
2025-09-23T04:29:49Z,pre_sentiment,gpt-4.1-mini,288,1,289
2025-09-23T04:29:50Z,sentiment,gpt-4.1-mini,1579,109,1688
2025-09-23T04:30:04Z,pre_sentiment,gpt-4.1-mini,287,1,288
2025-09-23T04:30:06Z,sentiment,gpt-4.1-mini,1152,168,1320
2025-09-23T04:30:17Z,pre_sentiment,gpt-4.1-mini,293,1,294
2025-09-23T04:30:17Z,pre_sentiment,gpt-4.1-mini,286,1,287
2025-09-23T04:30:17Z,pre_sentiment,gpt-4.1-mini,283,1,284
2025-09-23T04:30:21Z,sentiment,gpt-4.1-mini,1387,212,1599
2025-09-23T04:30:22Z,pre_sentiment,gpt-4.1-mini,280,1,281
2025-09-23T04:30:24Z,sentiment,gpt-4.1-mini,1307,158,1465
2025-09-23T04:30:25Z,pre_sentiment,gpt-4.1-mini,298,1,299
2025-09-23T04:30:25Z,pre_sentiment,gpt-4.1-mini,277,1,278
2025-09-23T04:30:28Z,sentiment,gpt-4.1-mini,918,111,1029
2025-09-23T04:30:28Z,pre_sentiment,gpt-4.1-mini,286,1,287
2025-09-23T04:30:31Z,sentiment,gpt-4.1-mini,1615,204,1819
2025-09-23T04:30:48Z,pre_sentiment,gpt-4.1-mini,289,1,290
2025-09-23T04:30:52Z,sentiment,gpt-4.1-mini,3077,241,3318
2025-09-23T04:30:52Z,pre_sentiment,gpt-4.1-mini,285,1,286
2025-09-23T04:31:06Z,pre_sentiment,gpt-4.1-mini,289,1,290
2025-09-23T04:31:07Z,pre_sentiment,gpt-4.1-mini,283,1,284
2025-09-23T04:31:07Z,pre_sentiment,gpt-4.1-mini,287,1,288
2025-09-23T04:31:08Z,pre_sentiment,gpt-4.1-mini,286,1,287
2025-09-23T04:31:11Z,sentiment,gpt-4.1-mini,1126,151,1277
2025-09-23T04:31:11Z,pre_sentiment,gpt-4.1-mini,299,1,300
2025-09-23T04:31:14Z,sentiment,gpt-4.1-mini,1263,177,1440
2025-09-23T04:31:14Z,pre_sentiment,gpt-4.1-mini,279,1,280
2025-09-23T04:31:15Z,pre_sentiment,gpt-4.1-mini,284,1,285
2025-09-23T04:31:15Z,pre_sentiment,gpt-4.1-mini,286,1,287
2025-09-23T04:31:16Z,pre_sentiment,gpt-4.1-mini,280,1,281
2025-09-23T04:31:19Z,sentiment,gpt-4.1-mini,1189,188,1377
2025-09-23T04:31:19Z,pre_sentiment,gpt-4.1-mini,281,1,282
2025-09-23T04:31:22Z,sentiment,gpt-4.1-mini,1154,175,1329
2025-09-23T04:31:31Z,article_selection,gpt-4.1-mini,1307,9,1316
2025-09-23T04:31:32Z,article_selection,gpt-4.1-mini,1812,12,1824
2025-09-23T04:31:32Z,article_selection,gpt-4.1-mini,489,5,494
2025-09-23T04:31:33Z,article_selection,gpt-4.1-mini,866,16,882
2025-09-23T04:31:33Z,article_selection,gpt-4.1-mini,412,5,417
2025-09-23T04:31:52Z,final_summary_en,gpt-4.1-mini,1368,1111,2479
2025-09-23T04:32:04Z,final_summary_en,gpt-4.1-mini,1556,1137,2693
2025-09-23T04:32:18Z,final_summary_en,gpt-4.1-mini,1500,1075,2575
2025-09-23T04:32:28Z,final_summary_en,gpt-4.1-mini,1603,1201,2804
2025-09-23T04:32:49Z,final_summary_en,gpt-4.1-mini,1298,1262,2560
2025-09-23T04:33:18Z,final_summary_en,gpt-4.1-mini,1709,1237,2946
2025-09-23T04:33:57Z,final_summary_en,gpt-4.1-mini,1137,1177,2314
2025-09-23T04:34:09Z,final_summary_en,gpt-4.1-mini,945,940,1885
2025-09-23T04:34:28Z,final_summary_en,gpt-4.1-mini,1579,1193,2772
2025-09-23T04:34:44Z,final_summary_en,gpt-4.1-mini,1384,1106,2490
2025-09-23T04:35:12Z,final_summary_en,gpt-4.1-mini,2479,1354,3833
2025-09-23T04:35:43Z,final_summary_en,gpt-4.1-mini,990,1236,2226
2025-09-23T04:35:57Z,final_summary_en,gpt-4.1-mini,2876,1268,4144
2025-09-23T04:36:10Z,final_summary_en,gpt-4.1-mini,1042,1084,2126
2025-09-23T04:36:22Z,final_summary_en,gpt-4.1-mini,1003,1034,2037
2025-09-23T04:36:33Z,final_summary_en,gpt-4.1-mini,1355,938,2293
2025-09-23T04:36:45Z,final_summary_en,gpt-4.1-mini,1004,1013,2017
2025-09-23T04:36:58Z,final_summary_en,gpt-4.1-mini,1159,1042,2201
2025-09-23T04:38:02Z,category_summary,gpt-4.1-mini,134,29,163
2025-09-23T04:38:04Z,category_summary,gpt-4.1-mini,139,39,178
2025-09-23T04:38:06Z,category_summary,gpt-4.1-mini,104,26,130
2025-09-23T04:38:08Z,category_summary,gpt-4.1-mini,123,42,165
2025-09-23T04:38:11Z,category_summary,gpt-4.1-mini,101,30,131
2025-09-23T04:38:13Z,category_summary,gpt-4.1-mini,98,26,124
2025-09-23T04:38:14Z,RUN_TOTAL,,133904,29014,162918
2025-09-24T04:24:56Z,pre_sentiment,gpt-4.1-mini,283,1,284
2025-09-24T04:24:57Z,pre_sentiment,gpt-4.1-mini,280,1,281
2025-09-24T04:24:58Z,pre_sentiment,gpt-4.1-mini,288,1,289
2025-09-24T04:24:59Z,pre_sentiment,gpt-4.1-mini,290,1,291
2025-09-24T04:25:00Z,pre_sentiment,gpt-4.1-mini,283,1,284
2025-09-24T04:25:05Z,sentiment,gpt-4.1-mini,3594,222,3816
2025-09-24T04:25:05Z,pre_sentiment,gpt-4.1-mini,291,1,292
2025-09-24T04:25:06Z,pre_sentiment,gpt-4.1-mini,278,1,279
2025-09-24T04:25:06Z,pre_sentiment,gpt-4.1-mini,280,1,281
2025-09-24T04:25:07Z,pre_sentiment,gpt-4.1-mini,281,1,282
2025-09-24T04:25:12Z,sentiment,gpt-4.1-mini,1713,135,1848
2025-09-24T04:25:13Z,pre_sentiment,gpt-4.1-mini,286,1,287
2025-09-24T04:25:13Z,pre_sentiment,gpt-4.1-mini,284,1,285
2025-09-24T04:25:16Z,sentiment,gpt-4.1-mini,2711,180,2891
2025-09-24T04:25:17Z,pre_sentiment,gpt-4.1-mini,292,1,293
2025-09-24T04:25:17Z,pre_sentiment,gpt-4.1-mini,279,1,280
2025-09-24T04:25:17Z,pre_sentiment,gpt-4.1-mini,278,1,279
2025-09-24T04:25:18Z,pre_sentiment,gpt-4.1-mini,288,1,289
2025-09-24T04:25:24Z,pre_sentiment,gpt-4.1-mini,288,1,289
2025-09-24T04:25:27Z,sentiment,gpt-4.1-mini,1163,217,1380
2025-09-24T04:25:27Z,pre_sentiment,gpt-4.1-mini,283,1,284
2025-09-24T04:25:28Z,pre_sentiment,gpt-4.1-mini,293,1,294
2025-09-24T04:25:31Z,pre_sentiment,gpt-4.1-mini,288,1,289
2025-09-24T04:25:35Z,sentiment,gpt-4.1-mini,1976,221,2197
2025-09-24T04:25:40Z,pre_sentiment,gpt-4.1-mini,275,1,276
2025-09-24T04:25:43Z,sentiment,gpt-4.1-mini,1811,210,2021
2025-09-24T04:25:44Z,pre_sentiment,gpt-4.1-mini,282,1,283
2025-09-24T04:25:47Z,sentiment,gpt-4.1-mini,1573,169,1742
2025-09-24T04:25:48Z,pre_sentiment,gpt-4.1-mini,285,1,286
2025-09-24T04:25:50Z,sentiment,gpt-4.1-mini,1856,197,2053
2025-09-24T04:25:51Z,pre_sentiment,gpt-4.1-mini,280,1,281
2025-09-24T04:25:51Z,pre_sentiment,gpt-4.1-mini,287,1,288
2025-09-24T04:25:54Z,sentiment,gpt-4.1-mini,2637,201,2838
2025-09-24T04:25:55Z,pre_sentiment,gpt-4.1-mini,287,1,288
2025-09-24T04:25:57Z,sentiment,gpt-4.1-mini,1352,155,1507
2025-09-24T04:25:57Z,pre_sentiment,gpt-4.1-mini,285,1,286
2025-09-24T04:25:59Z,sentiment,gpt-4.1-mini,1665,201,1866
2025-09-24T04:26:00Z,pre_sentiment,gpt-4.1-mini,278,1,279
2025-09-24T04:26:02Z,sentiment,gpt-4.1-mini,1429,176,1605
2025-09-24T04:26:02Z,pre_sentiment,gpt-4.1-mini,288,1,289
2025-09-24T04:26:06Z,sentiment,gpt-4.1-mini,2264,232,2496
2025-09-24T04:26:06Z,pre_sentiment,gpt-4.1-mini,278,1,279
2025-09-24T04:26:09Z,sentiment,gpt-4.1-mini,1683,180,1863
2025-09-24T04:26:09Z,pre_sentiment,gpt-4.1-mini,278,1,279
2025-09-24T04:26:12Z,sentiment,gpt-4.1-mini,1846,209,2055
2025-09-24T04:26:12Z,pre_sentiment,gpt-4.1-mini,278,1,279
2025-09-24T04:26:15Z,sentiment,gpt-4.1-mini,1227,180,1407
2025-09-24T04:26:16Z,pre_sentiment,gpt-4.1-mini,284,1,285
2025-09-24T04:26:16Z,pre_sentiment,gpt-4.1-mini,280,1,281
2025-09-24T04:26:19Z,sentiment,gpt-4.1-mini,1739,203,1942
2025-09-24T04:26:20Z,pre_sentiment,gpt-4.1-mini,283,1,284
2025-09-24T04:26:25Z,sentiment,gpt-4.1-mini,1470,218,1688
2025-09-24T04:26:44Z,pre_sentiment,gpt-4.1-mini,298,1,299
2025-09-24T04:26:47Z,sentiment,gpt-4.1-mini,1112,203,1315
2025-09-24T04:26:47Z,pre_sentiment,gpt-4.1-mini,298,1,299
2025-09-24T04:26:49Z,sentiment,gpt-4.1-mini,934,96,1030
2025-09-24T04:26:49Z,pre_sentiment,gpt-4.1-mini,294,1,295
2025-09-24T04:26:51Z,sentiment,gpt-4.1-mini,905,86,991
2025-09-24T04:26:52Z,pre_sentiment,gpt-4.1-mini,290,1,291
2025-09-24T04:26:53Z,sentiment,gpt-4.1-mini,898,82,980
2025-09-24T04:26:54Z,pre_sentiment,gpt-4.1-mini,297,1,298
2025-09-24T04:26:55Z,sentiment,gpt-4.1-mini,909,94,1003
2025-09-24T04:26:56Z,pre_sentiment,gpt-4.1-mini,295,1,296
2025-09-24T04:26:57Z,sentiment,gpt-4.1-mini,905,96,1001
2025-09-24T04:26:58Z,pre_sentiment,gpt-4.1-mini,301,1,302
2025-09-24T04:27:00Z,sentiment,gpt-4.1-mini,1364,116,1480
2025-09-24T04:27:00Z,pre_sentiment,gpt-4.1-mini,301,1,302
2025-09-24T04:27:00Z,pre_sentiment,gpt-4.1-mini,306,1,307
2025-09-24T04:27:02Z,sentiment,gpt-4.1-mini,1279,120,1399
2025-09-24T04:27:03Z,pre_sentiment,gpt-4.1-mini,301,1,302
2025-09-24T04:27:03Z,pre_sentiment,gpt-4.1-mini,302,1,303
2025-09-24T04:27:04Z,pre_sentiment,gpt-4.1-mini,293,1,294
2025-09-24T04:27:06Z,sentiment,gpt-4.1-mini,1515,169,1684
2025-09-24T04:27:06Z,pre_sentiment,gpt-4.1-mini,306,1,307
2025-09-24T04:27:09Z,sentiment,gpt-4.1-mini,1556,127,1683
2025-09-24T04:27:09Z,pre_sentiment,gpt-4.1-mini,294,1,295
2025-09-24T04:27:12Z,sentiment,gpt-4.1-mini,5862,228,6090
2025-09-24T04:27:13Z,pre_sentiment,gpt-4.1-mini,300,1,301
2025-09-24T04:27:15Z,sentiment,gpt-4.1-mini,2952,216,3168
2025-09-24T04:27:26Z,pre_sentiment,gpt-4.1-mini,281,1,282
2025-09-24T04:27:29Z,sentiment,gpt-4.1-mini,2088,225,2313
2025-09-24T04:27:34Z,pre_sentiment,gpt-4.1-mini,294,1,295
2025-09-24T04:27:37Z,sentiment,gpt-4.1-mini,2067,173,2240
2025-09-24T04:27:38Z,pre_sentiment,gpt-4.1-mini,286,1,287
2025-09-24T04:27:40Z,sentiment,gpt-4.1-mini,1047,133,1180
2025-09-24T04:27:40Z,pre_sentiment,gpt-4.1-mini,284,1,285
2025-09-24T04:27:42Z,sentiment,gpt-4.1-mini,2293,151,2444
2025-09-24T04:27:48Z,pre_sentiment,gpt-4.1-mini,290,1,291
2025-09-24T04:27:52Z,sentiment,gpt-4.1-mini,1650,193,1843
2025-09-24T04:27:52Z,pre_sentiment,gpt-4.1-mini,279,1,280
2025-09-24T04:27:56Z,sentiment,gpt-4.1-mini,2741,212,2953
2025-09-24T04:28:01Z,pre_sentiment,gpt-4.1-mini,267,1,268
2025-09-24T04:28:01Z,pre_sentiment,gpt-4.1-mini,266,1,267
2025-09-24T04:28:02Z,pre_sentiment,gpt-4.1-mini,294,1,295
2025-09-24T04:28:02Z,pre_sentiment,gpt-4.1-mini,267,1,268
2025-09-24T04:28:15Z,pre_sentiment,gpt-4.1-mini,275,1,276
2025-09-24T04:28:16Z,pre_sentiment,gpt-4.1-mini,275,1,276
2025-09-24T04:28:16Z,pre_sentiment,gpt-4.1-mini,277,1,278
2025-09-24T04:28:16Z,pre_sentiment,gpt-4.1-mini,280,1,281
2025-09-24T04:28:17Z,pre_sentiment,gpt-4.1-mini,275,1,276
2025-09-24T04:28:17Z,pre_sentiment,gpt-4.1-mini,275,1,276
2025-09-24T04:28:30Z,pre_sentiment,gpt-4.1-mini,285,1,286
2025-09-24T04:28:32Z,sentiment,gpt-4.1-mini,1988,137,2125
2025-09-24T04:28:33Z,pre_sentiment,gpt-4.1-mini,288,1,289
2025-09-24T04:28:36Z,sentiment,gpt-4.1-mini,1541,158,1699
2025-09-24T04:28:36Z,pre_sentiment,gpt-4.1-mini,286,1,287
2025-09-24T04:28:39Z,sentiment,gpt-4.1-mini,1428,158,1586
2025-09-24T04:28:39Z,pre_sentiment,gpt-4.1-mini,283,1,284
2025-09-24T04:28:43Z,sentiment,gpt-4.1-mini,4130,194,4324
2025-09-24T04:28:44Z,pre_sentiment,gpt-4.1-mini,287,1,288
2025-09-24T04:28:47Z,sentiment,gpt-4.1-mini,1587,189,1776
2025-09-24T04:28:59Z,pre_sentiment,gpt-4.1-mini,286,1,287
2025-09-24T04:29:04Z,pre_sentiment,gpt-4.1-mini,282,1,283
2025-09-24T04:29:15Z,pre_sentiment,gpt-4.1-mini,289,1,290
2025-09-24T04:29:15Z,pre_sentiment,gpt-4.1-mini,291,1,292
2025-09-24T04:29:17Z,sentiment,gpt-4.1-mini,1120,148,1268
2025-09-24T04:29:21Z,pre_sentiment,gpt-4.1-mini,286,1,287
2025-09-24T04:29:21Z,pre_sentiment,gpt-4.1-mini,282,1,283
2025-09-24T04:29:30Z,pre_sentiment,gpt-4.1-mini,286,1,287
2025-09-24T04:29:39Z,pre_sentiment,gpt-4.1-mini,293,1,294
2025-09-24T04:29:43Z,sentiment,gpt-4.1-mini,1492,180,1672
2025-09-24T04:29:43Z,pre_sentiment,gpt-4.1-mini,294,1,295
2025-09-24T04:29:46Z,sentiment,gpt-4.1-mini,1830,151,1981
2025-09-24T04:29:53Z,pre_sentiment,gpt-4.1-mini,288,1,289
2025-09-24T04:29:53Z,pre_sentiment,gpt-4.1-mini,282,1,283
2025-09-24T04:29:56Z,sentiment,gpt-4.1-mini,1496,191,1687
2025-09-24T04:29:56Z,pre_sentiment,gpt-4.1-mini,284,1,285
2025-09-24T04:29:58Z,sentiment,gpt-4.1-mini,1309,205,1514
2025-09-24T04:30:06Z,pre_sentiment,gpt-4.1-mini,287,1,288
2025-09-24T04:30:07Z,pre_sentiment,gpt-4.1-mini,287,1,288
2025-09-24T04:30:07Z,pre_sentiment,gpt-4.1-mini,285,1,286
2025-09-24T04:30:08Z,pre_sentiment,gpt-4.1-mini,282,1,283
2025-09-24T04:30:08Z,pre_sentiment,gpt-4.1-mini,291,1,292
2025-09-24T04:30:09Z,pre_sentiment,gpt-4.1-mini,286,1,287
2025-09-24T04:30:11Z,sentiment,gpt-4.1-mini,1356,190,1546
2025-09-24T04:30:12Z,pre_sentiment,gpt-4.1-mini,299,1,300
2025-09-24T04:30:12Z,pre_sentiment,gpt-4.1-mini,288,1,289
2025-09-24T04:30:16Z,sentiment,gpt-4.1-mini,1452,196,1648
2025-09-24T04:30:16Z,pre_sentiment,gpt-4.1-mini,285,1,286
2025-09-24T04:30:20Z,sentiment,gpt-4.1-mini,1820,200,2020
2025-09-24T04:30:20Z,pre_sentiment,gpt-4.1-mini,293,1,294
2025-09-24T04:30:22Z,sentiment,gpt-4.1-mini,1023,126,1149
2025-09-24T04:30:23Z,pre_sentiment,gpt-4.1-mini,286,1,287
2025-09-24T04:30:26Z,sentiment,gpt-4.1-mini,1589,216,1805
2025-09-24T04:30:26Z,pre_sentiment,gpt-4.1-mini,277,1,278
2025-09-24T04:30:28Z,sentiment,gpt-4.1-mini,918,101,1019
2025-09-24T04:30:45Z,pre_sentiment,gpt-4.1-mini,285,1,286
2025-09-24T04:30:48Z,sentiment,gpt-4.1-mini,2812,251,3063
2025-09-24T04:30:49Z,pre_sentiment,gpt-4.1-mini,287,1,288
2025-09-24T04:30:51Z,sentiment,gpt-4.1-mini,2220,151,2371
2025-09-24T04:31:05Z,pre_sentiment,gpt-4.1-mini,288,1,289
2025-09-24T04:31:06Z,pre_sentiment,gpt-4.1-mini,282,1,283
2025-09-24T04:31:08Z,sentiment,gpt-4.1-mini,1119,128,1247
2025-09-24T04:31:09Z,pre_sentiment,gpt-4.1-mini,294,1,295
2025-09-24T04:31:12Z,sentiment,gpt-4.1-mini,1568,219,1787
2025-09-24T04:31:12Z,pre_sentiment,gpt-4.1-mini,283,1,284
2025-09-24T04:31:12Z,pre_sentiment,gpt-4.1-mini,281,1,282
2025-09-24T04:31:14Z,sentiment,gpt-4.1-mini,1165,143,1308
2025-09-24T04:31:15Z,pre_sentiment,gpt-4.1-mini,277,1,278
2025-09-24T04:31:18Z,sentiment,gpt-4.1-mini,1252,237,1489
2025-09-24T04:31:19Z,pre_sentiment,gpt-4.1-mini,279,1,280
2025-09-24T04:31:23Z,sentiment,gpt-4.1-mini,1191,197,1388
2025-09-24T04:31:23Z,pre_sentiment,gpt-4.1-mini,282,1,283
2025-09-24T04:31:26Z,sentiment,gpt-4.1-mini,1071,204,1275
2025-09-24T04:31:27Z,pre_sentiment,gpt-4.1-mini,290,1,291
2025-09-24T04:31:30Z,sentiment,gpt-4.1-mini,1517,206,1723
2025-09-24T04:31:40Z,article_selection,gpt-4.1-mini,1406,12,1418
2025-09-24T04:31:41Z,article_selection,gpt-4.1-mini,651,12,663
2025-09-24T04:31:41Z,article_selection,gpt-4.1-mini,1079,16,1095
2025-09-24T04:31:42Z,article_selection,gpt-4.1-mini,792,16,808
2025-09-24T04:31:42Z,article_selection,gpt-4.1-mini,999,12,1011
2025-09-24T04:31:44Z,article_selection,gpt-4.1-mini,984,16,1000
2025-09-24T04:31:57Z,final_summary_en,gpt-4.1-mini,1165,1062,2227
2025-09-24T04:32:07Z,final_summary_en,gpt-4.1-mini,1235,947,2182
2025-09-24T04:32:19Z,final_summary_en,gpt-4.1-mini,2707,998,3705
2025-09-24T04:32:31Z,final_summary_en,gpt-4.1-mini,1341,1192,2533
2025-09-24T04:32:44Z,final_summary_en,gpt-4.1-mini,1748,1161,2909
2025-09-24T04:32:56Z,final_summary_en,gpt-4.1-mini,2380,1129,3509
2025-09-24T04:33:05Z,final_summary_en,gpt-4.1-mini,1412,1003,2415
2025-09-24T04:33:17Z,final_summary_en,gpt-4.1-mini,1334,1058,2392
2025-09-24T04:33:31Z,final_summary_en,gpt-4.1-mini,1571,1169,2740
2025-09-24T04:33:45Z,final_summary_en,gpt-4.1-mini,1597,1057,2654
2025-09-24T04:33:58Z,final_summary_en,gpt-4.1-mini,1228,1169,2397
2025-09-24T04:34:11Z,final_summary_en,gpt-4.1-mini,2583,1349,3932
2025-09-24T04:34:23Z,final_summary_en,gpt-4.1-mini,853,990,1843
2025-09-24T04:34:34Z,final_summary_en,gpt-4.1-mini,1255,962,2217
2025-09-24T04:34:47Z,final_summary_en,gpt-4.1-mini,1261,1100,2361
2025-09-24T04:34:58Z,final_summary_en,gpt-4.1-mini,959,1039,1998
2025-09-24T04:35:09Z,final_summary_en,gpt-4.1-mini,1258,1085,2343
2025-09-24T04:35:23Z,final_summary_en,gpt-4.1-mini,1112,1228,2340
2025-09-24T04:35:35Z,final_summary_en,gpt-4.1-mini,1578,1235,2813
2025-09-24T04:35:50Z,final_summary_en,gpt-4.1-mini,3376,1371,4747
2025-09-24T04:36:04Z,final_summary_en,gpt-4.1-mini,1309,1062,2371
2025-09-24T04:36:17Z,final_summary_en,gpt-4.1-mini,2025,1169,3194
2025-09-24T04:36:28Z,final_summary_en,gpt-4.1-mini,941,983,1924
2025-09-24T04:36:39Z,final_summary_en,gpt-4.1-mini,1340,1018,2358
2025-09-24T04:36:55Z,final_summary_en,gpt-4.1-mini,1162,1248,2410
2025-09-24T04:38:22Z,category_summary,gpt-4.1-mini,127,31,158
2025-09-24T04:38:25Z,category_summary,gpt-4.1-mini,129,28,157
2025-09-24T04:38:28Z,category_summary,gpt-4.1-mini,120,32,152
2025-09-24T04:38:30Z,category_summary,gpt-4.1-mini,143,30,173
2025-09-24T04:38:32Z,category_summary,gpt-4.1-mini,140,36,176
2025-09-24T04:38:35Z,category_summary,gpt-4.1-mini,141,33,174
2025-09-24T04:38:36Z,RUN_TOTAL,,181249,38865,220114
2025-09-25T04:25:51Z,pre_sentiment,gpt-4.1-mini,278,1,279
2025-09-25T04:25:53Z,sentiment,gpt-4.1-mini,1406,130,1536
2025-09-25T04:25:54Z,pre_sentiment,gpt-4.1-mini,291,1,292
2025-09-25T04:25:54Z,pre_sentiment,gpt-4.1-mini,275,1,276
2025-09-25T04:25:55Z,pre_sentiment,gpt-4.1-mini,286,1,287
2025-09-25T04:25:55Z,pre_sentiment,gpt-4.1-mini,283,1,284
2025-09-25T04:25:56Z,pre_sentiment,gpt-4.1-mini,284,1,285
2025-09-25T04:25:59Z,sentiment,gpt-4.1-mini,1953,159,2112
2025-09-25T04:26:00Z,pre_sentiment,gpt-4.1-mini,289,1,290
2025-09-25T04:26:00Z,pre_sentiment,gpt-4.1-mini,280,1,281
2025-09-25T04:26:00Z,pre_sentiment,gpt-4.1-mini,278,1,279
2025-09-25T04:26:00Z,pre_sentiment,gpt-4.1-mini,295,1,296
2025-09-25T04:26:02Z,pre_sentiment,gpt-4.1-mini,279,1,280
2025-09-25T04:26:02Z,pre_sentiment,gpt-4.1-mini,281,1,282
2025-09-25T04:26:05Z,sentiment,gpt-4.1-mini,1984,255,2239
2025-09-25T04:26:06Z,pre_sentiment,gpt-4.1-mini,284,1,285
2025-09-25T04:26:07Z,pre_sentiment,gpt-4.1-mini,291,1,292
2025-09-25T04:26:07Z,pre_sentiment,gpt-4.1-mini,290,1,291
2025-09-25T04:26:09Z,sentiment,gpt-4.1-mini,2151,147,2298
2025-09-25T04:26:15Z,pre_sentiment,gpt-4.1-mini,282,1,283
2025-09-25T04:26:16Z,pre_sentiment,gpt-4.1-mini,280,1,281
2025-09-25T04:26:19Z,sentiment,gpt-4.1-mini,1242,222,1464
2025-09-25T04:26:20Z,pre_sentiment,gpt-4.1-mini,283,1,284
2025-09-25T04:26:26Z,pre_sentiment,gpt-4.1-mini,279,1,280
2025-09-25T04:26:26Z,pre_sentiment,gpt-4.1-mini,285,1,286
2025-09-25T04:26:26Z,pre_sentiment,gpt-4.1-mini,285,1,286
2025-09-25T04:26:29Z,sentiment,gpt-4.1-mini,2337,209,2546
2025-09-25T04:26:34Z,pre_sentiment,gpt-4.1-mini,284,1,285
2025-09-25T04:26:38Z,sentiment,gpt-4.1-mini,2495,205,2700
2025-09-25T04:26:38Z,pre_sentiment,gpt-4.1-mini,283,1,284
2025-09-25T04:26:42Z,sentiment,gpt-4.1-mini,1957,237,2194
2025-09-25T04:26:42Z,pre_sentiment,gpt-4.1-mini,285,1,286
2025-09-25T04:26:45Z,sentiment,gpt-4.1-mini,2694,185,2879
2025-09-25T04:26:45Z,pre_sentiment,gpt-4.1-mini,288,1,289
2025-09-25T04:26:50Z,sentiment,gpt-4.1-mini,2292,219,2511
2025-09-25T04:26:50Z,pre_sentiment,gpt-4.1-mini,281,1,282
2025-09-25T04:26:53Z,sentiment,gpt-4.1-mini,1844,190,2034
2025-09-25T04:26:54Z,pre_sentiment,gpt-4.1-mini,286,1,287
2025-09-25T04:26:56Z,sentiment,gpt-4.1-mini,1945,197,2142
2025-09-25T04:26:57Z,pre_sentiment,gpt-4.1-mini,286,1,287
2025-09-25T04:27:01Z,sentiment,gpt-4.1-mini,1700,198,1898
2025-09-25T04:27:01Z,pre_sentiment,gpt-4.1-mini,283,1,284
2025-09-25T04:27:03Z,sentiment,gpt-4.1-mini,1620,190,1810
2025-09-25T04:27:04Z,pre_sentiment,gpt-4.1-mini,276,1,277
2025-09-25T04:27:08Z,sentiment,gpt-4.1-mini,1650,216,1866
2025-09-25T04:27:08Z,pre_sentiment,gpt-4.1-mini,285,1,286
2025-09-25T04:27:09Z,pre_sentiment,gpt-4.1-mini,280,1,281
2025-09-25T04:27:25Z,pre_sentiment,gpt-4.1-mini,301,1,302
2025-09-25T04:27:28Z,sentiment,gpt-4.1-mini,1180,208,1388
2025-09-25T04:27:29Z,pre_sentiment,gpt-4.1-mini,297,1,298
2025-09-25T04:27:32Z,sentiment,gpt-4.1-mini,1403,186,1589
2025-09-25T04:27:32Z,pre_sentiment,gpt-4.1-mini,294,1,295
2025-09-25T04:27:35Z,sentiment,gpt-4.1-mini,6567,181,6748
2025-09-25T04:27:36Z,pre_sentiment,gpt-4.1-mini,298,1,299
2025-09-25T04:27:40Z,sentiment,gpt-4.1-mini,3370,198,3568
2025-09-25T04:27:40Z,pre_sentiment,gpt-4.1-mini,301,1,302
2025-09-25T04:27:43Z,sentiment,gpt-4.1-mini,8422,225,8647
2025-09-25T04:27:43Z,pre_sentiment,gpt-4.1-mini,297,1,298
2025-09-25T04:27:47Z,sentiment,gpt-4.1-mini,4795,179,4974
2025-09-25T04:27:47Z,pre_sentiment,gpt-4.1-mini,293,1,294
2025-09-25T04:27:50Z,sentiment,gpt-4.1-mini,6918,155,7073
2025-09-25T04:27:50Z,pre_sentiment,gpt-4.1-mini,306,1,307
2025-09-25T04:27:54Z,sentiment,gpt-4.1-mini,1179,207,1386
2025-09-25T04:27:54Z,pre_sentiment,gpt-4.1-mini,297,1,298
2025-09-25T04:27:57Z,sentiment,gpt-4.1-mini,5357,152,5509
2025-09-25T04:27:57Z,pre_sentiment,gpt-4.1-mini,301,1,302
2025-09-25T04:28:00Z,sentiment,gpt-4.1-mini,4534,234,4768
2025-09-25T04:28:01Z,pre_sentiment,gpt-4.1-mini,302,1,303
2025-09-25T04:28:04Z,sentiment,gpt-4.1-mini,9347,222,9569
2025-09-25T04:28:04Z,pre_sentiment,gpt-4.1-mini,295,1,296
2025-09-25T04:28:09Z,sentiment,gpt-4.1-mini,16986,239,17225
2025-09-25T04:28:09Z,pre_sentiment,gpt-4.1-mini,296,1,297
2025-09-25T04:28:12Z,sentiment,gpt-4.1-mini,11076,212,11288
2025-09-25T04:28:12Z,pre_sentiment,gpt-4.1-mini,296,1,297
2025-09-25T04:28:16Z,sentiment,gpt-4.1-mini,3119,238,3357
2025-09-25T04:28:16Z,pre_sentiment,gpt-4.1-mini,293,1,294
2025-09-25T04:28:18Z,sentiment,gpt-4.1-mini,1249,142,1391
2025-09-25T04:28:38Z,pre_sentiment,gpt-4.1-mini,276,1,277
2025-09-25T04:28:40Z,sentiment,gpt-4.1-mini,1120,128,1248
2025-09-25T04:28:40Z,pre_sentiment,gpt-4.1-mini,279,1,280
2025-09-25T04:28:44Z,sentiment,gpt-4.1-mini,1922,243,2165
2025-09-25T04:28:45Z,pre_sentiment,gpt-4.1-mini,279,1,280
2025-09-25T04:28:48Z,sentiment,gpt-4.1-mini,1750,153,1903
2025-09-25T04:28:48Z,pre_sentiment,gpt-4.1-mini,284,1,285
2025-09-25T04:28:51Z,sentiment,gpt-4.1-mini,1302,186,1488
2025-09-25T04:28:51Z,pre_sentiment,gpt-4.1-mini,280,1,281
2025-09-25T04:28:54Z,sentiment,gpt-4.1-mini,1617,168,1785
2025-09-25T04:28:54Z,pre_sentiment,gpt-4.1-mini,285,1,286
2025-09-25T04:28:58Z,sentiment,gpt-4.1-mini,1778,213,1991
2025-09-25T04:28:58Z,pre_sentiment,gpt-4.1-mini,285,1,286
2025-09-25T04:29:02Z,sentiment,gpt-4.1-mini,2378,264,2642
2025-09-25T04:29:03Z,pre_sentiment,gpt-4.1-mini,282,1,283
2025-09-25T04:29:05Z,sentiment,gpt-4.1-mini,1146,128,1274
2025-09-25T04:29:05Z,pre_sentiment,gpt-4.1-mini,282,1,283
2025-09-25T04:29:07Z,sentiment,gpt-4.1-mini,1020,124,1144
2025-09-25T04:29:07Z,pre_sentiment,gpt-4.1-mini,296,1,297
2025-09-25T04:29:10Z,sentiment,gpt-4.1-mini,2815,193,3008
2025-09-25T04:29:15Z,pre_sentiment,gpt-4.1-mini,287,1,288
2025-09-25T04:29:17Z,sentiment,gpt-4.1-mini,1996,170,2166
2025-09-25T04:29:18Z,pre_sentiment,gpt-4.1-mini,286,1,287
2025-09-25T04:29:21Z,sentiment,gpt-4.1-mini,1196,192,1388
2025-09-25T04:29:41Z,pre_sentiment,gpt-4.1-mini,260,1,261
2025-09-25T04:29:41Z,pre_sentiment,gpt-4.1-mini,290,1,291
2025-09-25T04:29:41Z,pre_sentiment,gpt-4.1-mini,260,1,261
2025-09-25T04:29:42Z,pre_sentiment,gpt-4.1-mini,268,1,269
2025-09-25T04:29:46Z,sentiment,gpt-4.1-mini,2970,256,3226
2025-09-25T04:29:53Z,pre_sentiment,gpt-4.1-mini,274,1,275
2025-09-25T04:29:53Z,pre_sentiment,gpt-4.1-mini,278,1,279
2025-09-25T04:29:56Z,sentiment,gpt-4.1-mini,1841,191,2032
2025-09-25T04:29:56Z,pre_sentiment,gpt-4.1-mini,277,1,278
2025-09-25T04:29:57Z,pre_sentiment,gpt-4.1-mini,274,1,275
2025-09-25T04:30:00Z,sentiment,gpt-4.1-mini,1782,226,2008
2025-09-25T04:30:00Z,pre_sentiment,gpt-4.1-mini,275,1,276
2025-09-25T04:30:01Z,pre_sentiment,gpt-4.1-mini,275,1,276
2025-09-25T04:30:06Z,pre_sentiment,gpt-4.1-mini,280,1,281
2025-09-25T04:30:10Z,sentiment,gpt-4.1-mini,1665,232,1897
2025-09-25T04:30:10Z,pre_sentiment,gpt-4.1-mini,282,1,283
2025-09-25T04:30:13Z,sentiment,gpt-4.1-mini,1674,190,1864
2025-09-25T04:30:13Z,pre_sentiment,gpt-4.1-mini,287,1,288
2025-09-25T04:30:16Z,sentiment,gpt-4.1-mini,1852,208,2060
2025-09-25T04:30:16Z,pre_sentiment,gpt-4.1-mini,282,1,283
2025-09-25T04:30:19Z,sentiment,gpt-4.1-mini,1294,182,1476
2025-09-25T04:30:19Z,pre_sentiment,gpt-4.1-mini,291,1,292
2025-09-25T04:30:22Z,sentiment,gpt-4.1-mini,1365,194,1559
2025-09-25T04:30:23Z,pre_sentiment,gpt-4.1-mini,284,1,285
2025-09-25T04:30:26Z,sentiment,gpt-4.1-mini,4065,223,4288
2025-09-25T04:30:26Z,pre_sentiment,gpt-4.1-mini,284,1,285
2025-09-25T04:30:29Z,sentiment,gpt-4.1-mini,1802,184,1986
2025-09-25T04:30:38Z,pre_sentiment,gpt-4.1-mini,279,1,280
2025-09-25T04:30:42Z,sentiment,gpt-4.1-mini,2023,233,2256
2025-09-25T04:30:43Z,pre_sentiment,gpt-4.1-mini,284,1,285
2025-09-25T04:30:43Z,pre_sentiment,gpt-4.1-mini,292,1,293
2025-09-25T04:30:45Z,sentiment,gpt-4.1-mini,899,122,1021
2025-09-25T04:30:56Z,pre_sentiment,gpt-4.1-mini,293,1,294
2025-09-25T04:30:56Z,pre_sentiment,gpt-4.1-mini,282,1,283
2025-09-25T04:30:57Z,sentiment,gpt-4.1-mini,901,97,998
2025-09-25T04:31:01Z,pre_sentiment,gpt-4.1-mini,284,1,285
2025-09-25T04:31:02Z,pre_sentiment,gpt-4.1-mini,292,1,293
2025-09-25T04:31:04Z,sentiment,gpt-4.1-mini,899,137,1036
2025-09-25T04:31:27Z,pre_sentiment,gpt-4.1-mini,294,1,295
2025-09-25T04:31:30Z,sentiment,gpt-4.1-mini,1830,147,1977
2025-09-25T04:31:39Z,pre_sentiment,gpt-4.1-mini,280,1,281
2025-09-25T04:31:42Z,sentiment,gpt-4.1-mini,1539,198,1737
2025-09-25T04:31:47Z,pre_sentiment,gpt-4.1-mini,285,1,286
2025-09-25T04:31:50Z,sentiment,gpt-4.1-mini,1535,252,1787
2025-09-25T04:31:51Z,pre_sentiment,gpt-4.1-mini,285,1,286
2025-09-25T04:31:53Z,sentiment,gpt-4.1-mini,1171,167,1338
2025-09-25T04:31:53Z,pre_sentiment,gpt-4.1-mini,286,1,287
2025-09-25T04:31:56Z,sentiment,gpt-4.1-mini,1836,226,2062
2025-09-25T04:31:57Z,pre_sentiment,gpt-4.1-mini,281,1,282
2025-09-25T04:31:57Z,pre_sentiment,gpt-4.1-mini,290,1,291
2025-09-25T04:31:59Z,sentiment,gpt-4.1-mini,991,167,1158
2025-09-25T04:32:00Z,pre_sentiment,gpt-4.1-mini,281,1,282
2025-09-25T04:32:02Z,sentiment,gpt-4.1-mini,1297,195,1492
2025-09-25T04:32:02Z,pre_sentiment,gpt-4.1-mini,281,1,282
2025-09-25T04:32:03Z,pre_sentiment,gpt-4.1-mini,286,1,287
2025-09-25T04:32:03Z,pre_sentiment,gpt-4.1-mini,300,1,301
2025-09-25T04:32:06Z,sentiment,gpt-4.1-mini,1754,186,1940
2025-09-25T04:32:06Z,pre_sentiment,gpt-4.1-mini,289,1,290
2025-09-25T04:32:09Z,sentiment,gpt-4.1-mini,1416,138,1554
2025-09-25T04:32:09Z,pre_sentiment,gpt-4.1-mini,281,1,282
2025-09-25T04:32:10Z,pre_sentiment,gpt-4.1-mini,285,1,286
2025-09-25T04:32:11Z,pre_sentiment,gpt-4.1-mini,283,1,284
2025-09-25T04:32:14Z,sentiment,gpt-4.1-mini,1785,243,2028
2025-09-25T04:32:14Z,pre_sentiment,gpt-4.1-mini,278,1,279
2025-09-25T04:32:15Z,pre_sentiment,gpt-4.1-mini,277,1,278
2025-09-25T04:32:18Z,sentiment,gpt-4.1-mini,918,111,1029
2025-09-25T04:32:29Z,pre_sentiment,gpt-4.1-mini,290,1,291
2025-09-25T04:32:29Z,pre_sentiment,gpt-4.1-mini,286,1,287
2025-09-25T04:32:33Z,sentiment,gpt-4.1-mini,2409,197,2606
2025-09-25T04:32:43Z,pre_sentiment,gpt-4.1-mini,279,1,280
2025-09-25T04:32:44Z,pre_sentiment,gpt-4.1-mini,280,1,281
2025-09-25T04:32:47Z,sentiment,gpt-4.1-mini,1344,248,1592
2025-09-25T04:32:47Z,pre_sentiment,gpt-4.1-mini,284,1,285
2025-09-25T04:32:50Z,sentiment,gpt-4.1-mini,1059,191,1250
2025-09-25T04:32:51Z,pre_sentiment,gpt-4.1-mini,294,1,295
2025-09-25T04:32:51Z,pre_sentiment,gpt-4.1-mini,291,1,292
2025-09-25T04:32:51Z,pre_sentiment,gpt-4.1-mini,292,1,293
2025-09-25T04:32:55Z,sentiment,gpt-4.1-mini,1722,229,1951
2025-09-25T04:32:55Z,pre_sentiment,gpt-4.1-mini,285,1,286
2025-09-25T04:32:56Z,pre_sentiment,gpt-4.1-mini,284,1,285
2025-09-25T04:32:56Z,pre_sentiment,gpt-4.1-mini,293,1,294
2025-09-25T04:32:58Z,sentiment,gpt-4.1-mini,1515,163,1678
2025-09-25T04:32:59Z,pre_sentiment,gpt-4.1-mini,277,1,278
2025-09-25T04:33:02Z,sentiment,gpt-4.1-mini,1268,178,1446
2025-09-25T04:33:02Z,pre_sentiment,gpt-4.1-mini,286,1,287
2025-09-25T04:33:05Z,sentiment,gpt-4.1-mini,1276,137,1413
2025-09-25T04:33:05Z,pre_sentiment,gpt-4.1-mini,284,1,285
2025-09-25T04:33:09Z,sentiment,gpt-4.1-mini,2884,230,3114
2025-09-25T04:33:09Z,pre_sentiment,gpt-4.1-mini,304,1,305
2025-09-25T04:33:12Z,sentiment,gpt-4.1-mini,1468,228,1696
2025-09-25T04:33:12Z,pre_sentiment,gpt-4.1-mini,288,1,289
2025-09-25T04:33:13Z,pre_sentiment,gpt-4.1-mini,282,1,283
2025-09-25T04:33:21Z,article_selection,gpt-4.1-mini,1824,16,1840
2025-09-25T04:33:21Z,article_selection,gpt-4.1-mini,2028,16,2044
2025-09-25T04:33:22Z,article_selection,gpt-4.1-mini,1614,16,1630
2025-09-25T04:33:22Z,article_selection,gpt-4.1-mini,985,12,997
2025-09-25T04:33:23Z,article_selection,gpt-4.1-mini,2284,12,2296
2025-09-25T04:33:23Z,article_selection,gpt-4.1-mini,513,7,520
2025-09-25T04:33:39Z,final_summary_en,gpt-4.1-mini,1444,1139,2583
2025-09-25T04:33:56Z,final_summary_en,gpt-4.1-mini,2164,1157,3321
2025-09-25T04:34:16Z,final_summary_en,gpt-4.1-mini,1609,1468,3077
2025-09-25T04:34:41Z,final_summary_en,gpt-4.1-mini,1429,1159,2588
2025-09-25T04:34:57Z,final_summary_en,gpt-4.1-mini,1410,1387,2797
2025-09-25T04:35:13Z,final_summary_en,gpt-4.1-mini,1710,1136,2846
2025-09-25T04:35:28Z,final_summary_en,gpt-4.1-mini,1687,1009,2696
2025-09-25T04:35:50Z,final_summary_en,gpt-4.1-mini,1525,1312,2837
2025-09-25T04:36:09Z,final_summary_en,gpt-4.1-mini,941,1292,2233
2025-09-25T04:36:31Z,final_summary_en,gpt-4.1-mini,1591,1193,2784
2025-09-25T04:36:50Z,final_summary_en,gpt-4.1-mini,934,1133,2067
2025-09-25T04:37:05Z,final_summary_en,gpt-4.1-mini,2903,907,3810
2025-09-25T04:37:26Z,final_summary_en,gpt-4.1-mini,2083,1199,3282
2025-09-25T04:37:45Z,final_summary_en,gpt-4.1-mini,2046,1238,3284
2025-09-25T04:38:10Z,final_summary_en,gpt-4.1-mini,2565,1139,3704
2025-09-25T04:38:25Z,final_summary_en,gpt-4.1-mini,3820,1103,4923
2025-09-25T04:38:38Z,final_summary_en,gpt-4.1-mini,1585,1013,2598
2025-09-25T04:38:55Z,final_summary_en,gpt-4.1-mini,1296,1123,2419
2025-09-25T04:39:13Z,final_summary_en,gpt-4.1-mini,1217,1189,2406
2025-09-25T04:39:27Z,final_summary_en,gpt-4.1-mini,1555,1016,2571
2025-09-25T04:39:42Z,final_summary_en,gpt-4.1-mini,2166,1007,3173
2025-09-25T04:39:58Z,final_summary_en,gpt-4.1-mini,1113,1116,2229
2025-09-25T04:40:15Z,final_summary_en,gpt-4.1-mini,1017,1087,2104
2025-09-25T04:41:45Z,category_summary,gpt-4.1-mini,129,31,160
2025-09-25T04:41:47Z,category_summary,gpt-4.1-mini,127,33,160
2025-09-25T04:41:49Z,category_summary,gpt-4.1-mini,134,25,159
2025-09-25T04:41:51Z,category_summary,gpt-4.1-mini,144,40,184
2025-09-25T04:41:54Z,category_summary,gpt-4.1-mini,136,37,173
2025-09-25T04:41:56Z,category_summary,gpt-4.1-mini,113,31,144
2025-09-25T04:41:57Z,RUN_TOTAL,,274093,41520,315613
2025-09-26T04:25:51Z,pre_sentiment,gpt-4.1-mini,279,1,280
2025-09-26T04:25:52Z,pre_sentiment,gpt-4.1-mini,282,1,283
2025-09-26T04:25:54Z,pre_sentiment,gpt-4.1-mini,284,1,285
2025-09-26T04:25:55Z,pre_sentiment,gpt-4.1-mini,287,1,288
2025-09-26T04:25:55Z,pre_sentiment,gpt-4.1-mini,286,1,287
2025-09-26T04:25:56Z,pre_sentiment,gpt-4.1-mini,283,1,284
2025-09-26T04:25:56Z,pre_sentiment,gpt-4.1-mini,286,1,287
2025-09-26T04:25:58Z,sentiment,gpt-4.1-mini,1323,131,1454
2025-09-26T04:25:59Z,pre_sentiment,gpt-4.1-mini,276,1,277
2025-09-26T04:26:02Z,sentiment,gpt-4.1-mini,2183,223,2406
2025-09-26T04:26:02Z,pre_sentiment,gpt-4.1-mini,285,1,286
2025-09-26T04:26:03Z,pre_sentiment,gpt-4.1-mini,283,1,284
2025-09-26T04:26:03Z,pre_sentiment,gpt-4.1-mini,283,1,284
2025-09-26T04:26:04Z,pre_sentiment,gpt-4.1-mini,278,1,279
2025-09-26T04:26:05Z,pre_sentiment,gpt-4.1-mini,282,1,283
2025-09-26T04:26:05Z,pre_sentiment,gpt-4.1-mini,293,1,294
2025-09-26T04:26:05Z,pre_sentiment,gpt-4.1-mini,285,1,286
2025-09-26T04:26:08Z,sentiment,gpt-4.1-mini,1986,155,2141
2025-09-26T04:26:14Z,pre_sentiment,gpt-4.1-mini,279,1,280
2025-09-26T04:26:15Z,pre_sentiment,gpt-4.1-mini,293,1,294
2025-09-26T04:26:15Z,pre_sentiment,gpt-4.1-mini,279,1,280
2025-09-26T04:26:15Z,pre_sentiment,gpt-4.1-mini,282,1,283
2025-09-26T04:26:16Z,pre_sentiment,gpt-4.1-mini,285,1,286
2025-09-26T04:26:16Z,pre_sentiment,gpt-4.1-mini,278,1,279
2025-09-26T04:26:20Z,sentiment,gpt-4.1-mini,2060,215,2275
2025-09-26T04:26:20Z,pre_sentiment,gpt-4.1-mini,293,1,294
2025-09-26T04:26:25Z,pre_sentiment,gpt-4.1-mini,286,1,287
2025-09-26T04:26:26Z,pre_sentiment,gpt-4.1-mini,281,1,282
2025-09-26T04:26:29Z,sentiment,gpt-4.1-mini,1839,206,2045
2025-09-26T04:26:30Z,pre_sentiment,gpt-4.1-mini,279,1,280
2025-09-26T04:26:30Z,pre_sentiment,gpt-4.1-mini,285,1,286
2025-09-26T04:26:35Z,pre_sentiment,gpt-4.1-mini,284,1,285
2025-09-26T04:26:38Z,sentiment,gpt-4.1-mini,2370,216,2586
2025-09-26T04:26:38Z,pre_sentiment,gpt-4.1-mini,277,1,278
2025-09-26T04:26:42Z,sentiment,gpt-4.1-mini,1674,190,1864
2025-09-26T04:26:42Z,pre_sentiment,gpt-4.1-mini,284,1,285
2025-09-26T04:26:46Z,sentiment,gpt-4.1-mini,1565,217,1782
2025-09-26T04:26:47Z,pre_sentiment,gpt-4.1-mini,284,1,285
2025-09-26T04:26:51Z,sentiment,gpt-4.1-mini,1636,215,1851
2025-09-26T04:26:51Z,pre_sentiment,gpt-4.1-mini,291,1,292
2025-09-26T04:26:54Z,sentiment,gpt-4.1-mini,1958,195,2153
2025-09-26T04:26:55Z,pre_sentiment,gpt-4.1-mini,286,1,287
2025-09-26T04:26:58Z,sentiment,gpt-4.1-mini,1759,191,1950
2025-09-26T04:26:59Z,pre_sentiment,gpt-4.1-mini,281,1,282
2025-09-26T04:27:03Z,sentiment,gpt-4.1-mini,1587,200,1787
2025-09-26T04:27:04Z,pre_sentiment,gpt-4.1-mini,288,1,289
2025-09-26T04:27:07Z,sentiment,gpt-4.1-mini,1574,198,1772
2025-09-26T04:27:07Z,pre_sentiment,gpt-4.1-mini,284,1,285
2025-09-26T04:27:11Z,sentiment,gpt-4.1-mini,2495,219,2714
2025-09-26T04:27:29Z,pre_sentiment,gpt-4.1-mini,296,1,297
2025-09-26T04:27:31Z,sentiment,gpt-4.1-mini,913,108,1021
2025-09-26T04:27:31Z,pre_sentiment,gpt-4.1-mini,294,1,295
2025-09-26T04:27:33Z,sentiment,gpt-4.1-mini,909,89,998
2025-09-26T04:27:33Z,pre_sentiment,gpt-4.1-mini,299,1,300
2025-09-26T04:27:36Z,sentiment,gpt-4.1-mini,999,111,1110
2025-09-26T04:27:36Z,pre_sentiment,gpt-4.1-mini,299,1,300
2025-09-26T04:27:38Z,sentiment,gpt-4.1-mini,923,109,1032
2025-09-26T04:27:39Z,pre_sentiment,gpt-4.1-mini,302,1,303
2025-09-26T04:27:42Z,sentiment,gpt-4.1-mini,1567,201,1768
2025-09-26T04:27:42Z,pre_sentiment,gpt-4.1-mini,298,1,299
2025-09-26T04:27:46Z,sentiment,gpt-4.1-mini,1691,190,1881
2025-09-26T04:27:46Z,pre_sentiment,gpt-4.1-mini,298,1,299
2025-09-26T04:27:50Z,sentiment,gpt-4.1-mini,7178,241,7419
2025-09-26T04:27:50Z,pre_sentiment,gpt-4.1-mini,299,1,300
2025-09-26T04:27:54Z,sentiment,gpt-4.1-mini,1681,185,1866
2025-09-26T04:27:54Z,pre_sentiment,gpt-4.1-mini,294,1,295
2025-09-26T04:27:56Z,sentiment,gpt-4.1-mini,1491,142,1633
2025-09-26T04:27:57Z,pre_sentiment,gpt-4.1-mini,294,1,295
2025-09-26T04:28:01Z,sentiment,gpt-4.1-mini,1622,232,1854
2025-09-26T04:28:01Z,pre_sentiment,gpt-4.1-mini,302,1,303
2025-09-26T04:28:04Z,sentiment,gpt-4.1-mini,2609,200,2809
2025-09-26T04:28:04Z,pre_sentiment,gpt-4.1-mini,297,1,298
2025-09-26T04:28:08Z,sentiment,gpt-4.1-mini,1403,192,1595
2025-09-26T04:28:08Z,pre_sentiment,gpt-4.1-mini,294,1,295
2025-09-26T04:28:12Z,sentiment,gpt-4.1-mini,6567,178,6745
2025-09-26T04:28:12Z,pre_sentiment,gpt-4.1-mini,298,1,299
2025-09-26T04:28:15Z,sentiment,gpt-4.1-mini,3370,208,3578
2025-09-26T04:28:33Z,pre_sentiment,gpt-4.1-mini,279,1,280
2025-09-26T04:28:36Z,sentiment,gpt-4.1-mini,1970,219,2189
2025-09-26T04:28:37Z,pre_sentiment,gpt-4.1-mini,287,1,288
2025-09-26T04:28:40Z,sentiment,gpt-4.1-mini,1475,156,1631
2025-09-26T04:28:40Z,pre_sentiment,gpt-4.1-mini,287,1,288
2025-09-26T04:28:43Z,sentiment,gpt-4.1-mini,1374,166,1540
2025-09-26T04:28:43Z,pre_sentiment,gpt-4.1-mini,286,1,287
2025-09-26T04:28:45Z,sentiment,gpt-4.1-mini,1065,132,1197
2025-09-26T04:28:45Z,pre_sentiment,gpt-4.1-mini,290,1,291
2025-09-26T04:28:50Z,sentiment,gpt-4.1-mini,2268,238,2506
2025-09-26T04:28:51Z,pre_sentiment,gpt-4.1-mini,278,1,279
2025-09-26T04:28:57Z,sentiment,gpt-4.1-mini,1363,402,1765
2025-09-26T04:28:58Z,pre_sentiment,gpt-4.1-mini,290,1,291
2025-09-26T04:29:00Z,sentiment,gpt-4.1-mini,1436,138,1574
2025-09-26T04:29:00Z,pre_sentiment,gpt-4.1-mini,289,1,290
2025-09-26T04:29:03Z,sentiment,gpt-4.1-mini,2013,209,2222
2025-09-26T04:29:04Z,pre_sentiment,gpt-4.1-mini,285,1,286
2025-09-26T04:29:07Z,sentiment,gpt-4.1-mini,1560,152,1712
2025-09-26T04:29:07Z,pre_sentiment,gpt-4.1-mini,282,1,283
2025-09-26T04:29:09Z,sentiment,gpt-4.1-mini,1147,141,1288
2025-09-26T04:29:20Z,pre_sentiment,gpt-4.1-mini,284,1,285
2025-09-26T04:29:22Z,sentiment,gpt-4.1-mini,876,110,986
2025-09-26T04:29:26Z,pre_sentiment,gpt-4.1-mini,283,1,284
2025-09-26T04:29:30Z,sentiment,gpt-4.1-mini,3574,225,3799
2025-09-26T04:29:36Z,pre_sentiment,gpt-4.1-mini,273,1,274
2025-09-26T04:29:38Z,sentiment,gpt-4.1-mini,2767,141,2908
2025-09-26T04:29:39Z,pre_sentiment,gpt-4.1-mini,278,1,279
2025-09-26T04:29:39Z,pre_sentiment,gpt-4.1-mini,273,1,274
2025-09-26T04:29:41Z,sentiment,gpt-4.1-mini,3693,138,3831
2025-09-26T04:29:41Z,pre_sentiment,gpt-4.1-mini,274,1,275
2025-09-26T04:29:54Z,pre_sentiment,gpt-4.1-mini,288,1,289
2025-09-26T04:29:58Z,sentiment,gpt-4.1-mini,2299,233,2532
2025-09-26T04:29:58Z,pre_sentiment,gpt-4.1-mini,280,1,281
2025-09-26T04:30:01Z,sentiment,gpt-4.1-mini,1306,204,1510
2025-09-26T04:30:02Z,pre_sentiment,gpt-4.1-mini,285,1,286
2025-09-26T04:30:05Z,sentiment,gpt-4.1-mini,1707,213,1920
2025-09-26T04:30:06Z,pre_sentiment,gpt-4.1-mini,280,1,281
2025-09-26T04:30:10Z,sentiment,gpt-4.1-mini,1429,186,1615
2025-09-26T04:30:35Z,pre_sentiment,gpt-4.1-mini,288,1,289
2025-09-26T04:30:38Z,sentiment,gpt-4.1-mini,1468,179,1647
2025-09-26T04:30:53Z,pre_sentiment,gpt-4.1-mini,290,1,291
2025-09-26T04:30:57Z,sentiment,gpt-4.1-mini,1624,211,1835
2025-09-26T04:30:57Z,pre_sentiment,gpt-4.1-mini,300,1,301
2025-09-26T04:31:02Z,sentiment,gpt-4.1-mini,1542,151,1693
2025-09-26T04:31:02Z,pre_sentiment,gpt-4.1-mini,296,1,297
2025-09-26T04:31:05Z,sentiment,gpt-4.1-mini,1740,218,1958
2025-09-26T04:31:05Z,pre_sentiment,gpt-4.1-mini,287,1,288
2025-09-26T04:31:11Z,sentiment,gpt-4.1-mini,1968,167,2135
2025-09-26T04:31:27Z,pre_sentiment,gpt-4.1-mini,288,1,289
2025-09-26T04:31:30Z,sentiment,gpt-4.1-mini,1862,204,2066
2025-09-26T04:31:31Z,pre_sentiment,gpt-4.1-mini,280,1,281
2025-09-26T04:31:31Z,pre_sentiment,gpt-4.1-mini,290,1,291
2025-09-26T04:31:32Z,pre_sentiment,gpt-4.1-mini,286,1,287
2025-09-26T04:31:36Z,sentiment,gpt-4.1-mini,1788,210,1998
2025-09-26T04:31:36Z,pre_sentiment,gpt-4.1-mini,286,1,287
2025-09-26T04:31:37Z,pre_sentiment,gpt-4.1-mini,287,1,288
2025-09-26T04:31:39Z,sentiment,gpt-4.1-mini,1623,200,1823
2025-09-26T04:31:40Z,pre_sentiment,gpt-4.1-mini,284,1,285
2025-09-26T04:31:42Z,sentiment,gpt-4.1-mini,1437,139,1576
2025-09-26T04:31:42Z,pre_sentiment,gpt-4.1-mini,288,1,289
2025-09-26T04:31:45Z,sentiment,gpt-4.1-mini,1284,196,1480
2025-09-26T04:31:45Z,pre_sentiment,gpt-4.1-mini,286,1,287
2025-09-26T04:31:46Z,pre_sentiment,gpt-4.1-mini,281,1,282
2025-09-26T04:31:50Z,sentiment,gpt-4.1-mini,1469,227,1696
2025-09-26T04:31:50Z,pre_sentiment,gpt-4.1-mini,280,1,281
2025-09-26T04:31:53Z,sentiment,gpt-4.1-mini,1513,210,1723
2025-09-26T04:31:54Z,pre_sentiment,gpt-4.1-mini,278,1,279
2025-09-26T04:31:55Z,pre_sentiment,gpt-4.1-mini,277,1,278
2025-09-26T04:31:56Z,sentiment,gpt-4.1-mini,918,111,1029
2025-09-26T04:32:12Z,pre_sentiment,gpt-4.1-mini,288,1,289
2025-09-26T04:32:15Z,sentiment,gpt-4.1-mini,2412,229,2641
2025-09-26T04:32:16Z,pre_sentiment,gpt-4.1-mini,289,1,290
2025-09-26T04:32:18Z,sentiment,gpt-4.1-mini,2341,198,2539
2025-09-26T04:32:34Z,pre_sentiment,gpt-4.1-mini,293,1,294
2025-09-26T04:32:36Z,sentiment,gpt-4.1-mini,1797,195,1992
2025-09-26T04:32:37Z,pre_sentiment,gpt-4.1-mini,281,1,282
2025-09-26T04:32:37Z,pre_sentiment,gpt-4.1-mini,286,1,287
2025-09-26T04:32:38Z,pre_sentiment,gpt-4.1-mini,279,1,280
2025-09-26T04:32:41Z,sentiment,gpt-4.1-mini,1692,227,1919
2025-09-26T04:32:41Z,pre_sentiment,gpt-4.1-mini,280,1,281
2025-09-26T04:32:42Z,pre_sentiment,gpt-4.1-mini,282,1,283
2025-09-26T04:32:42Z,pre_sentiment,gpt-4.1-mini,280,1,281
2025-09-26T04:32:43Z,pre_sentiment,gpt-4.1-mini,283,1,284
2025-09-26T04:32:45Z,sentiment,gpt-4.1-mini,1024,136,1160
2025-09-26T04:32:54Z,article_selection,gpt-4.1-mini,1773,9,1782
2025-09-26T04:32:55Z,article_selection,gpt-4.1-mini,1162,16,1178
2025-09-26T04:32:55Z,article_selection,gpt-4.1-mini,954,12,966
2025-09-26T04:32:56Z,article_selection,gpt-4.1-mini,1582,12,1594
2025-09-26T04:32:57Z,article_selection,gpt-4.1-mini,653,13,666
2025-09-26T04:32:57Z,article_selection,gpt-4.1-mini,486,6,492
2025-09-26T04:33:12Z,final_summary_en,gpt-4.1-mini,1195,1060,2255
2025-09-26T04:33:28Z,final_summary_en,gpt-4.1-mini,1955,1160,3115
2025-09-26T04:33:34Z,final_summary_en,gpt-4.1-mini,1413,1034,2447
2025-09-26T04:33:56Z,final_summary_en,gpt-4.1-mini,1408,1150,2558
2025-09-26T04:34:15Z,final_summary_en,gpt-4.1-mini,1701,1320,3021
2025-09-26T04:34:27Z,final_summary_en,gpt-4.1-mini,1833,978,2811
2025-09-26T04:34:44Z,final_summary_en,gpt-4.1-mini,1396,1159,2555
2025-09-26T04:35:00Z,final_summary_en,gpt-4.1-mini,1264,1203,2467
2025-09-26T04:35:20Z,final_summary_en,gpt-4.1-mini,1377,1251,2628
2025-09-26T04:35:39Z,final_summary_en,gpt-4.1-mini,1319,1107,2426
2025-09-26T04:35:54Z,final_summary_en,gpt-4.1-mini,6311,1138,7449
2025-09-26T04:36:11Z,final_summary_en,gpt-4.1-mini,1337,1081,2418
2025-09-26T04:36:25Z,final_summary_en,gpt-4.1-mini,1482,992,2474
2025-09-26T04:36:43Z,final_summary_en,gpt-4.1-mini,3335,1394,4729
2025-09-26T04:36:57Z,final_summary_en,gpt-4.1-mini,1389,1108,2497
2025-09-26T04:37:10Z,final_summary_en,gpt-4.1-mini,2186,1062,3248
2025-09-26T04:37:24Z,final_summary_en,gpt-4.1-mini,1720,1115,2835
2025-09-26T04:37:39Z,final_summary_en,gpt-4.1-mini,2045,1196,3241
2025-09-26T04:37:56Z,final_summary_en,gpt-4.1-mini,1775,1226,3001
2025-09-26T04:38:13Z,final_summary_en,gpt-4.1-mini,6951,1332,8283
2025-09-26T04:38:28Z,final_summary_en,gpt-4.1-mini,1702,871,2573
2025-09-26T04:39:52Z,category_summary,gpt-4.1-mini,131,37,168
2025-09-26T04:39:56Z,category_summary,gpt-4.1-mini,134,33,167
2025-09-26T04:39:58Z,category_summary,gpt-4.1-mini,127,26,153
2025-09-26T04:40:01Z,category_summary,gpt-4.1-mini,138,37,175
2025-09-26T04:40:04Z,category_summary,gpt-4.1-mini,115,41,156
2025-09-26T04:40:07Z,category_summary,gpt-4.1-mini,102,22,124
2025-09-26T04:40:08Z,RUN_TOTAL,,201946,36266,238212
2025-09-27T04:24:27Z,pre_sentiment,gpt-4.1-mini,280,1,281
2025-09-27T04:24:28Z,pre_sentiment,gpt-4.1-mini,286,1,287
2025-09-27T04:24:31Z,sentiment,gpt-4.1-mini,1149,174,1323
2025-09-27T04:24:31Z,pre_sentiment,gpt-4.1-mini,287,1,288
2025-09-27T04:24:32Z,pre_sentiment,gpt-4.1-mini,285,1,286
2025-09-27T04:24:33Z,pre_sentiment,gpt-4.1-mini,283,1,284
2025-09-27T04:24:36Z,sentiment,gpt-4.1-mini,1894,221,2115
2025-09-27T04:24:36Z,pre_sentiment,gpt-4.1-mini,286,1,287
2025-09-27T04:24:37Z,pre_sentiment,gpt-4.1-mini,284,1,285
2025-09-27T04:24:40Z,sentiment,gpt-4.1-mini,1300,157,1457
2025-09-27T04:24:40Z,pre_sentiment,gpt-4.1-mini,284,1,285
2025-09-27T04:24:41Z,pre_sentiment,gpt-4.1-mini,280,1,281
2025-09-27T04:24:41Z,pre_sentiment,gpt-4.1-mini,280,1,281
2025-09-27T04:24:42Z,pre_sentiment,gpt-4.1-mini,285,1,286
2025-09-27T04:24:42Z,pre_sentiment,gpt-4.1-mini,292,1,293
2025-09-27T04:24:45Z,sentiment,gpt-4.1-mini,1717,135,1852
2025-09-27T04:24:46Z,pre_sentiment,gpt-4.1-mini,289,1,290
2025-09-27T04:24:46Z,pre_sentiment,gpt-4.1-mini,284,1,285
2025-09-27T04:24:49Z,sentiment,gpt-4.1-mini,2354,191,2545
2025-09-27T04:24:55Z,pre_sentiment,gpt-4.1-mini,283,1,284
2025-09-27T04:24:56Z,pre_sentiment,gpt-4.1-mini,289,1,290
2025-09-27T04:24:58Z,sentiment,gpt-4.1-mini,1311,161,1472
2025-09-27T04:25:04Z,pre_sentiment,gpt-4.1-mini,286,1,287
2025-09-27T04:25:08Z,pre_sentiment,gpt-4.1-mini,285,1,286
2025-09-27T04:25:12Z,sentiment,gpt-4.1-mini,1895,223,2118
2025-09-27T04:25:12Z,pre_sentiment,gpt-4.1-mini,285,1,286
2025-09-27T04:25:15Z,sentiment,gpt-4.1-mini,2386,211,2597
2025-09-27T04:25:16Z,pre_sentiment,gpt-4.1-mini,280,1,281
2025-09-27T04:25:19Z,sentiment,gpt-4.1-mini,1496,218,1714
2025-09-27T04:25:20Z,pre_sentiment,gpt-4.1-mini,283,1,284
2025-09-27T04:25:23Z,sentiment,gpt-4.1-mini,1471,205,1676
2025-09-27T04:25:24Z,pre_sentiment,gpt-4.1-mini,282,1,283
2025-09-27T04:25:26Z,sentiment,gpt-4.1-mini,1433,154,1587
2025-09-27T04:25:26Z,pre_sentiment,gpt-4.1-mini,287,1,288
2025-09-27T04:25:29Z,sentiment,gpt-4.1-mini,1167,191,1358
2025-09-27T04:25:30Z,pre_sentiment,gpt-4.1-mini,281,1,282
2025-09-27T04:25:33Z,sentiment,gpt-4.1-mini,2220,197,2417
2025-09-27T04:25:33Z,pre_sentiment,gpt-4.1-mini,284,1,285
2025-09-27T04:25:37Z,sentiment,gpt-4.1-mini,1534,222,1756
2025-09-27T04:25:37Z,pre_sentiment,gpt-4.1-mini,284,1,285
2025-09-27T04:25:41Z,sentiment,gpt-4.1-mini,2370,207,2577
2025-09-27T04:25:59Z,pre_sentiment,gpt-4.1-mini,301,1,302
2025-09-27T04:26:01Z,sentiment,gpt-4.1-mini,1079,118,1197
2025-09-27T04:26:02Z,pre_sentiment,gpt-4.1-mini,296,1,297
2025-09-27T04:26:03Z,sentiment,gpt-4.1-mini,913,105,1018
2025-09-27T04:26:04Z,pre_sentiment,gpt-4.1-mini,301,1,302
2025-09-27T04:26:06Z,sentiment,gpt-4.1-mini,1339,175,1514
2025-09-27T04:26:07Z,pre_sentiment,gpt-4.1-mini,301,1,302
2025-09-27T04:26:10Z,sentiment,gpt-4.1-mini,1659,199,1858
2025-09-27T04:26:11Z,pre_sentiment,gpt-4.1-mini,304,1,305
2025-09-27T04:26:15Z,sentiment,gpt-4.1-mini,1671,227,1898
2025-09-27T04:26:15Z,pre_sentiment,gpt-4.1-mini,295,1,296
2025-09-27T04:26:18Z,sentiment,gpt-4.1-mini,1430,171,1601
2025-09-27T04:26:18Z,pre_sentiment,gpt-4.1-mini,294,1,295
2025-09-27T04:26:20Z,sentiment,gpt-4.1-mini,909,91,1000
2025-09-27T04:26:20Z,pre_sentiment,gpt-4.1-mini,299,1,300
2025-09-27T04:26:23Z,sentiment,gpt-4.1-mini,999,116,1115
2025-09-27T04:26:23Z,pre_sentiment,gpt-4.1-mini,299,1,300
2025-09-27T04:26:25Z,sentiment,gpt-4.1-mini,923,131,1054
2025-09-27T04:26:26Z,pre_sentiment,gpt-4.1-mini,293,1,294
2025-09-27T04:26:29Z,sentiment,gpt-4.1-mini,1920,194,2114
2025-09-27T04:26:29Z,pre_sentiment,gpt-4.1-mini,298,1,299
2025-09-27T04:26:33Z,sentiment,gpt-4.1-mini,1692,199,1891
2025-09-27T04:26:35Z,pre_sentiment,gpt-4.1-mini,299,1,300
2025-09-27T04:26:39Z,sentiment,gpt-4.1-mini,1681,178,1859
2025-09-27T04:26:39Z,pre_sentiment,gpt-4.1-mini,294,1,295
2025-09-27T04:26:42Z,sentiment,gpt-4.1-mini,1491,177,1668
2025-09-27T04:27:00Z,pre_sentiment,gpt-4.1-mini,288,1,289
2025-09-27T04:27:03Z,sentiment,gpt-4.1-mini,1661,211,1872
2025-09-27T04:27:04Z,pre_sentiment,gpt-4.1-mini,282,1,283
2025-09-27T04:27:06Z,sentiment,gpt-4.1-mini,1095,117,1212
2025-09-27T04:27:06Z,pre_sentiment,gpt-4.1-mini,288,1,289
2025-09-27T04:27:10Z,sentiment,gpt-4.1-mini,1723,259,1982
2025-09-27T04:27:11Z,pre_sentiment,gpt-4.1-mini,282,1,283
2025-09-27T04:27:14Z,sentiment,gpt-4.1-mini,3064,220,3284
2025-09-27T04:27:14Z,pre_sentiment,gpt-4.1-mini,287,1,288
2025-09-27T04:27:18Z,sentiment,gpt-4.1-mini,10947,268,11215
2025-09-27T04:27:19Z,pre_sentiment,gpt-4.1-mini,291,1,292
2025-09-27T04:27:22Z,sentiment,gpt-4.1-mini,3617,200,3817
2025-09-27T04:27:23Z,pre_sentiment,gpt-4.1-mini,277,1,278
2025-09-27T04:27:25Z,sentiment,gpt-4.1-mini,1042,139,1181
2025-09-27T04:27:25Z,pre_sentiment,gpt-4.1-mini,287,1,288
2025-09-27T04:27:28Z,sentiment,gpt-4.1-mini,1525,149,1674
2025-09-27T04:27:29Z,pre_sentiment,gpt-4.1-mini,279,1,280
2025-09-27T04:27:32Z,sentiment,gpt-4.1-mini,1514,209,1723
2025-09-27T04:27:33Z,pre_sentiment,gpt-4.1-mini,281,1,282
2025-09-27T04:27:35Z,sentiment,gpt-4.1-mini,1416,145,1561
2025-09-27T04:27:44Z,pre_sentiment,gpt-4.1-mini,286,1,287
2025-09-27T04:27:46Z,sentiment,gpt-4.1-mini,933,131,1064
2025-09-27T04:27:57Z,pre_sentiment,gpt-4.1-mini,271,1,272
2025-09-27T04:27:57Z,pre_sentiment,gpt-4.1-mini,289,1,290
2025-09-27T04:28:01Z,sentiment,gpt-4.1-mini,5097,196,5293
2025-09-27T04:28:06Z,pre_sentiment,gpt-4.1-mini,277,1,278
2025-09-27T04:28:07Z,pre_sentiment,gpt-4.1-mini,276,1,277
2025-09-27T04:28:07Z,pre_sentiment,gpt-4.1-mini,284,1,285
2025-09-27T04:28:08Z,pre_sentiment,gpt-4.1-mini,273,1,274
2025-09-27T04:28:09Z,sentiment,gpt-4.1-mini,2767,122,2889
2025-09-27T04:28:16Z,pre_sentiment,gpt-4.1-mini,277,1,278
2025-09-27T04:28:18Z,sentiment,gpt-4.1-mini,1815,190,2005
2025-09-27T04:28:19Z,pre_sentiment,gpt-4.1-mini,286,1,287
2025-09-27T04:28:21Z,sentiment,gpt-4.1-mini,1532,130,1662
2025-09-27T04:28:22Z,pre_sentiment,gpt-4.1-mini,282,1,283
2025-09-27T04:28:24Z,sentiment,gpt-4.1-mini,1609,148,1757
2025-09-27T04:28:25Z,pre_sentiment,gpt-4.1-mini,288,1,289
2025-09-27T04:28:27Z,sentiment,gpt-4.1-mini,1611,173,1784
2025-09-27T04:28:28Z,pre_sentiment,gpt-4.1-mini,277,1,278
2025-09-27T04:28:28Z,pre_sentiment,gpt-4.1-mini,285,1,286
2025-09-27T04:28:32Z,sentiment,gpt-4.1-mini,1893,218,2111
2025-09-27T04:28:39Z,pre_sentiment,gpt-4.1-mini,286,1,287
2025-09-27T04:28:42Z,sentiment,gpt-4.1-mini,1018,161,1179
2025-09-27T04:28:42Z,pre_sentiment,gpt-4.1-mini,294,1,295
2025-09-27T04:28:48Z,pre_sentiment,gpt-4.1-mini,286,1,287
2025-09-27T04:28:51Z,sentiment,gpt-4.1-mini,1132,162,1294
2025-09-27T04:28:51Z,pre_sentiment,gpt-4.1-mini,279,1,280
2025-09-27T04:28:53Z,sentiment,gpt-4.1-mini,1173,108,1281
2025-09-27T04:28:53Z,pre_sentiment,gpt-4.1-mini,292,1,293
2025-09-27T04:28:58Z,pre_sentiment,gpt-4.1-mini,294,1,295
2025-09-27T04:29:11Z,pre_sentiment,gpt-4.1-mini,296,1,297
2025-09-27T04:29:14Z,sentiment,gpt-4.1-mini,5857,239,6096
2025-09-27T04:29:15Z,pre_sentiment,gpt-4.1-mini,300,1,301
2025-09-27T04:29:17Z,sentiment,gpt-4.1-mini,1542,141,1683
2025-09-27T04:29:35Z,pre_sentiment,gpt-4.1-mini,285,1,286
2025-09-27T04:29:36Z,pre_sentiment,gpt-4.1-mini,283,1,284
2025-09-27T04:29:36Z,pre_sentiment,gpt-4.1-mini,302,1,303
2025-09-27T04:29:39Z,sentiment,gpt-4.1-mini,2033,213,2246
2025-09-27T04:29:40Z,pre_sentiment,gpt-4.1-mini,290,1,291
2025-09-27T04:29:44Z,sentiment,gpt-4.1-mini,1387,239,1626
2025-09-27T04:29:44Z,pre_sentiment,gpt-4.1-mini,288,1,289
2025-09-27T04:29:44Z,pre_sentiment,gpt-4.1-mini,289,1,290
2025-09-27T04:29:45Z,pre_sentiment,gpt-4.1-mini,285,1,286
2025-09-27T04:29:45Z,pre_sentiment,gpt-4.1-mini,288,1,289
2025-09-27T04:29:45Z,pre_sentiment,gpt-4.1-mini,290,1,291
2025-09-27T04:29:46Z,pre_sentiment,gpt-4.1-mini,275,1,276
2025-09-27T04:29:46Z,pre_sentiment,gpt-4.1-mini,278,1,279
2025-09-27T04:29:48Z,sentiment,gpt-4.1-mini,927,92,1019
2025-09-27T04:30:14Z,pre_sentiment,gpt-4.1-mini,295,1,296
2025-09-27T04:30:17Z,sentiment,gpt-4.1-mini,1556,120,1676
2025-09-27T04:30:17Z,pre_sentiment,gpt-4.1-mini,288,1,289
2025-09-27T04:30:19Z,sentiment,gpt-4.1-mini,1278,132,1410
2025-09-27T04:30:20Z,pre_sentiment,gpt-4.1-mini,290,1,291
2025-09-27T04:30:23Z,sentiment,gpt-4.1-mini,1083,181,1264
2025-09-27T04:30:23Z,pre_sentiment,gpt-4.1-mini,292,1,293
2025-09-27T04:30:26Z,sentiment,gpt-4.1-mini,1265,169,1434
2025-09-27T04:30:26Z,pre_sentiment,gpt-4.1-mini,279,1,280
2025-09-27T04:30:27Z,pre_sentiment,gpt-4.1-mini,284,1,285
2025-09-27T04:30:31Z,sentiment,gpt-4.1-mini,1438,136,1574
2025-09-27T04:30:31Z,pre_sentiment,gpt-4.1-mini,283,1,284
2025-09-27T04:30:34Z,sentiment,gpt-4.1-mini,1203,181,1384
2025-09-27T04:30:34Z,pre_sentiment,gpt-4.1-mini,285,1,286
2025-09-27T04:30:40Z,sentiment,gpt-4.1-mini,1182,215,1397
2025-09-27T04:30:41Z,pre_sentiment,gpt-4.1-mini,280,1,281
2025-09-27T04:30:44Z,sentiment,gpt-4.1-mini,1659,212,1871
2025-09-27T04:30:45Z,pre_sentiment,gpt-4.1-mini,287,1,288
2025-09-27T04:30:45Z,pre_sentiment,gpt-4.1-mini,283,1,284
2025-09-27T04:30:48Z,sentiment,gpt-4.1-mini,1265,215,1480
2025-09-27T04:30:48Z,pre_sentiment,gpt-4.1-mini,290,1,291
2025-09-27T04:30:48Z,pre_sentiment,gpt-4.1-mini,278,1,279
2025-09-27T04:30:49Z,pre_sentiment,gpt-4.1-mini,282,1,283
2025-09-27T04:30:51Z,sentiment,gpt-4.1-mini,2631,189,2820
2025-09-27T04:30:52Z,pre_sentiment,gpt-4.1-mini,284,1,285
2025-09-27T04:31:05Z,article_selection,gpt-4.1-mini,1302,12,1314
2025-09-27T04:31:05Z,article_selection,gpt-4.1-mini,1481,9,1490
2025-09-27T04:31:06Z,article_selection,gpt-4.1-mini,1287,12,1299
2025-09-27T04:31:06Z,article_selection,gpt-4.1-mini,604,9,613
2025-09-27T04:31:07Z,article_selection,gpt-4.1-mini,738,12,750
2025-09-27T04:31:08Z,article_selection,gpt-4.1-mini,1223,12,1235
2025-09-27T04:31:16Z,final_summary_en,gpt-4.1-mini,2117,1186,3303
2025-09-27T04:31:25Z,final_summary_en,gpt-4.1-mini,1456,1065,2521
2025-09-27T04:31:35Z,final_summary_en,gpt-4.1-mini,1790,1205,2995
2025-09-27T04:31:47Z,final_summary_en,gpt-4.1-mini,1562,1216,2778
2025-09-27T04:31:56Z,final_summary_en,gpt-4.1-mini,1254,1029,2283
2025-09-27T04:32:06Z,final_summary_en,gpt-4.1-mini,2140,1142,3282
2025-09-27T04:32:15Z,final_summary_en,gpt-4.1-mini,1226,976,2202
2025-09-27T04:32:23Z,final_summary_en,gpt-4.1-mini,748,847,1595
2025-09-27T04:32:33Z,final_summary_en,gpt-4.1-mini,1977,1239,3216
2025-09-27T04:32:45Z,final_summary_en,gpt-4.1-mini,2114,1389,3503
2025-09-27T04:32:54Z,final_summary_en,gpt-4.1-mini,1645,1166,2811
2025-09-27T04:33:04Z,final_summary_en,gpt-4.1-mini,1295,1046,2341
2025-09-27T04:33:13Z,final_summary_en,gpt-4.1-mini,1655,1026,2681
2025-09-27T04:33:26Z,final_summary_en,gpt-4.1-mini,5605,1379,6984
2025-09-27T04:33:43Z,final_summary_en,gpt-4.1-mini,1228,1233,2461
2025-09-27T04:33:54Z,final_summary_en,gpt-4.1-mini,1406,1206,2612
2025-09-27T04:34:04Z,final_summary_en,gpt-4.1-mini,2827,1109,3936
2025-09-27T04:34:13Z,final_summary_en,gpt-4.1-mini,1275,1118,2393
2025-09-27T04:34:22Z,final_summary_en,gpt-4.1-mini,918,1020,1938
2025-09-27T04:34:32Z,final_summary_en,gpt-4.1-mini,1407,1039,2446
2025-09-27T04:34:44Z,final_summary_en,gpt-4.1-mini,1172,1262,2434
2025-09-27T04:34:51Z,final_summary_en,gpt-4.1-mini,869,899,1768
2025-09-27T04:35:01Z,final_summary_en,gpt-4.1-mini,945,1034,1979
2025-09-27T04:36:59Z,category_summary,gpt-4.1-mini,147,41,188
2025-09-27T04:37:02Z,category_summary,gpt-4.1-mini,122,32,154
2025-09-27T04:37:05Z,category_summary,gpt-4.1-mini,125,28,153
2025-09-27T04:37:07Z,category_summary,gpt-4.1-mini,130,30,160
2025-09-27T04:37:09Z,category_summary,gpt-4.1-mini,131,37,168
2025-09-27T04:37:11Z,category_summary,gpt-4.1-mini,123,28,151
2025-09-27T04:37:13Z,RUN_TOTAL,,191458,37467,228925
2025-09-28T04:24:33Z,pre_sentiment,gpt-4.1-mini,288,1,289
2025-09-28T04:24:36Z,sentiment,gpt-4.1-mini,1181,156,1337
2025-09-28T04:24:37Z,pre_sentiment,gpt-4.1-mini,283,1,284
2025-09-28T04:24:37Z,pre_sentiment,gpt-4.1-mini,286,1,287
2025-09-28T04:24:38Z,pre_sentiment,gpt-4.1-mini,292,1,293
2025-09-28T04:24:39Z,pre_sentiment,gpt-4.1-mini,282,1,283
2025-09-28T04:24:39Z,pre_sentiment,gpt-4.1-mini,284,1,285
2025-09-28T04:24:42Z,sentiment,gpt-4.1-mini,1811,234,2045
2025-09-28T04:24:42Z,pre_sentiment,gpt-4.1-mini,291,1,292
2025-09-28T04:24:44Z,sentiment,gpt-4.1-mini,1119,158,1277
2025-09-28T04:24:45Z,pre_sentiment,gpt-4.1-mini,287,1,288
2025-09-28T04:24:46Z,sentiment,gpt-4.1-mini,1352,125,1477
2025-09-28T04:24:46Z,pre_sentiment,gpt-4.1-mini,284,1,285
2025-09-28T04:24:49Z,sentiment,gpt-4.1-mini,1185,119,1304
2025-09-28T04:24:49Z,pre_sentiment,gpt-4.1-mini,290,1,291
2025-09-28T04:24:50Z,pre_sentiment,gpt-4.1-mini,285,1,286
2025-09-28T04:24:50Z,pre_sentiment,gpt-4.1-mini,284,1,285
2025-09-28T04:24:50Z,pre_sentiment,gpt-4.1-mini,289,1,290
2025-09-28T04:24:51Z,pre_sentiment,gpt-4.1-mini,286,1,287
2025-09-28T04:25:10Z,pre_sentiment,gpt-4.1-mini,275,1,276
2025-09-28T04:25:12Z,sentiment,gpt-4.1-mini,1961,225,2186
2025-09-28T04:25:12Z,pre_sentiment,gpt-4.1-mini,278,1,279
2025-09-28T04:25:14Z,sentiment,gpt-4.1-mini,1910,181,2091
2025-09-28T04:25:15Z,pre_sentiment,gpt-4.1-mini,289,1,290
2025-09-28T04:25:15Z,pre_sentiment,gpt-4.1-mini,286,1,287
2025-09-28T04:25:17Z,sentiment,gpt-4.1-mini,1281,193,1474
2025-09-28T04:25:18Z,pre_sentiment,gpt-4.1-mini,286,1,287
2025-09-28T04:25:20Z,sentiment,gpt-4.1-mini,2485,213,2698
2025-09-28T04:25:20Z,pre_sentiment,gpt-4.1-mini,281,1,282
2025-09-28T04:25:23Z,sentiment,gpt-4.1-mini,1908,232,2140
2025-09-28T04:25:41Z,pre_sentiment,gpt-4.1-mini,301,1,302
2025-09-28T04:25:43Z,sentiment,gpt-4.1-mini,1079,127,1206
2025-09-28T04:25:43Z,pre_sentiment,gpt-4.1-mini,296,1,297
2025-09-28T04:25:44Z,sentiment,gpt-4.1-mini,913,93,1006
2025-09-28T04:25:44Z,pre_sentiment,gpt-4.1-mini,301,1,302
2025-09-28T04:25:46Z,sentiment,gpt-4.1-mini,1339,175,1514
2025-09-28T04:25:47Z,pre_sentiment,gpt-4.1-mini,301,1,302
2025-09-28T04:25:49Z,sentiment,gpt-4.1-mini,1659,204,1863
2025-09-28T04:25:50Z,pre_sentiment,gpt-4.1-mini,304,1,305
2025-09-28T04:25:53Z,sentiment,gpt-4.1-mini,1671,231,1902
2025-09-28T04:25:53Z,pre_sentiment,gpt-4.1-mini,295,1,296
2025-09-28T04:25:55Z,sentiment,gpt-4.1-mini,1430,139,1569
2025-09-28T04:25:55Z,pre_sentiment,gpt-4.1-mini,294,1,295
2025-09-28T04:25:57Z,sentiment,gpt-4.1-mini,909,109,1018
2025-09-28T04:25:57Z,pre_sentiment,gpt-4.1-mini,299,1,300
2025-09-28T04:25:59Z,sentiment,gpt-4.1-mini,999,113,1112
2025-09-28T04:25:59Z,pre_sentiment,gpt-4.1-mini,299,1,300
2025-09-28T04:26:00Z,sentiment,gpt-4.1-mini,923,122,1045
2025-09-28T04:26:01Z,pre_sentiment,gpt-4.1-mini,293,1,294
2025-09-28T04:26:03Z,sentiment,gpt-4.1-mini,1920,179,2099
2025-09-28T04:26:03Z,pre_sentiment,gpt-4.1-mini,299,1,300
2025-09-28T04:26:37Z,pre_sentiment,gpt-4.1-mini,273,1,274
2025-09-28T04:27:14Z,pre_sentiment,gpt-4.1-mini,289,1,290
2025-09-28T04:27:17Z,sentiment,gpt-4.1-mini,2049,220,2269
2025-09-28T04:27:23Z,pre_sentiment,gpt-4.1-mini,294,1,295
2025-09-28T04:27:25Z,sentiment,gpt-4.1-mini,1107,126,1233
2025-09-28T04:27:25Z,pre_sentiment,gpt-4.1-mini,287,1,288
2025-09-28T04:27:27Z,sentiment,gpt-4.1-mini,1588,128,1716
2025-09-28T04:28:12Z,pre_sentiment,gpt-4.1-mini,290,1,291
2025-09-28T04:28:13Z,pre_sentiment,gpt-4.1-mini,288,1,289
2025-09-28T04:28:13Z,pre_sentiment,gpt-4.1-mini,280,1,281
2025-09-28T04:28:15Z,sentiment,gpt-4.1-mini,943,105,1048
2025-09-28T04:28:31Z,pre_sentiment,gpt-4.1-mini,290,1,291
2025-09-28T04:28:34Z,sentiment,gpt-4.1-mini,2113,254,2367
2025-09-28T04:28:35Z,pre_sentiment,gpt-4.1-mini,284,1,285
2025-09-28T04:28:38Z,sentiment,gpt-4.1-mini,2330,228,2558
2025-09-28T04:28:38Z,pre_sentiment,gpt-4.1-mini,285,1,286
2025-09-28T04:28:40Z,sentiment,gpt-4.1-mini,2442,204,2646
2025-09-28T04:29:05Z,article_selection,gpt-4.1-mini,942,16,958
2025-09-28T04:29:05Z,article_selection,gpt-4.1-mini,475,9,484
2025-09-28T04:29:06Z,article_selection,gpt-4.1-mini,454,6,460
2025-09-28T04:29:06Z,article_selection,gpt-4.1-mini,372,6,378
2025-09-28T04:29:07Z,article_selection,gpt-4.1-mini,480,9,489
2025-09-28T04:29:24Z,final_summary_en,gpt-4.1-mini,1713,1273,2986
2025-09-28T04:29:38Z,final_summary_en,gpt-4.1-mini,1656,1041,2697
2025-09-28T04:29:51Z,final_summary_en,gpt-4.1-mini,1663,1037,2700
2025-09-28T04:30:03Z,final_summary_en,gpt-4.1-mini,1640,978,2618
2025-09-28T04:30:16Z,final_summary_en,gpt-4.1-mini,1041,1092,2133
2025-09-28T04:30:31Z,final_summary_en,gpt-4.1-mini,2237,1033,3270
2025-09-28T04:30:50Z,final_summary_en,gpt-4.1-mini,1798,1387,3185
2025-09-28T04:31:09Z,final_summary_en,gpt-4.1-mini,1449,1371,2820
2025-09-28T04:31:30Z,final_summary_en,gpt-4.1-mini,2103,1464,3567
2025-09-28T04:31:45Z,final_summary_en,gpt-4.1-mini,2200,1047,3247
2025-09-28T04:32:00Z,final_summary_en,gpt-4.1-mini,1572,1098,2670
2025-09-28T04:32:14Z,final_summary_en,gpt-4.1-mini,850,999,1849
2025-09-28T04:32:33Z,final_summary_en,gpt-4.1-mini,1894,1225,3119
2025-09-28T04:33:20Z,category_summary,gpt-4.1-mini,117,36,153
2025-09-28T04:33:23Z,category_summary,gpt-4.1-mini,113,32,145
2025-09-28T04:33:25Z,category_summary,gpt-4.1-mini,102,26,128
2025-09-28T04:33:27Z,category_summary,gpt-4.1-mini,104,19,123
2025-09-28T04:33:29Z,category_summary,gpt-4.1-mini,122,21,143
2025-09-28T04:33:30Z,RUN_TOTAL,,78552,19859,98411
2025-09-29T04:26:18Z,pre_sentiment,gpt-4.1-mini,284,1,285
2025-09-29T04:26:18Z,pre_sentiment,gpt-4.1-mini,280,1,281
2025-09-29T04:26:19Z,pre_sentiment,gpt-4.1-mini,282,1,283
2025-09-29T04:26:20Z,pre_sentiment,gpt-4.1-mini,285,1,286
2025-09-29T04:26:20Z,pre_sentiment,gpt-4.1-mini,282,1,283
2025-09-29T04:26:22Z,sentiment,gpt-4.1-mini,1691,99,1790
2025-09-29T04:26:23Z,pre_sentiment,gpt-4.1-mini,288,1,289
2025-09-29T04:26:23Z,pre_sentiment,gpt-4.1-mini,282,1,283
2025-09-29T04:26:24Z,pre_sentiment,gpt-4.1-mini,286,1,287
2025-09-29T04:26:27Z,sentiment,gpt-4.1-mini,1759,214,1973
2025-09-29T04:26:27Z,pre_sentiment,gpt-4.1-mini,278,1,279
2025-09-29T04:26:28Z,pre_sentiment,gpt-4.1-mini,282,1,283
2025-09-29T04:26:28Z,pre_sentiment,gpt-4.1-mini,277,1,278
2025-09-29T04:26:29Z,pre_sentiment,gpt-4.1-mini,285,1,286
2025-09-29T04:26:29Z,pre_sentiment,gpt-4.1-mini,288,1,289
2025-09-29T04:26:32Z,sentiment,gpt-4.1-mini,1990,178,2168
2025-09-29T04:26:32Z,pre_sentiment,gpt-4.1-mini,284,1,285
2025-09-29T04:26:33Z,pre_sentiment,gpt-4.1-mini,282,1,283
2025-09-29T04:26:54Z,pre_sentiment,gpt-4.1-mini,280,1,281
2025-09-29T04:26:59Z,sentiment,gpt-4.1-mini,1539,211,1750
2025-09-29T04:26:59Z,pre_sentiment,gpt-4.1-mini,285,1,286
2025-09-29T04:27:03Z,sentiment,gpt-4.1-mini,1392,260,1652
2025-09-29T04:27:04Z,pre_sentiment,gpt-4.1-mini,283,1,284
2025-09-29T04:27:07Z,sentiment,gpt-4.1-mini,2353,254,2607
2025-09-29T04:27:08Z,pre_sentiment,gpt-4.1-mini,285,1,286
2025-09-29T04:27:11Z,sentiment,gpt-4.1-mini,1593,203,1796
2025-09-29T04:27:11Z,pre_sentiment,gpt-4.1-mini,282,1,283
2025-09-29T04:27:14Z,sentiment,gpt-4.1-mini,1942,187,2129
2025-09-29T04:27:15Z,pre_sentiment,gpt-4.1-mini,282,1,283
2025-09-29T04:27:19Z,sentiment,gpt-4.1-mini,1572,195,1767
2025-09-29T04:27:19Z,pre_sentiment,gpt-4.1-mini,282,1,283
2025-09-29T04:27:22Z,sentiment,gpt-4.1-mini,1738,206,1944
2025-09-29T04:27:23Z,pre_sentiment,gpt-4.1-mini,276,1,277
2025-09-29T04:27:25Z,sentiment,gpt-4.1-mini,1416,168,1584
2025-09-29T04:27:26Z,pre_sentiment,gpt-4.1-mini,282,1,283
2025-09-29T04:27:30Z,sentiment,gpt-4.1-mini,1428,183,1611
2025-09-29T04:27:30Z,pre_sentiment,gpt-4.1-mini,282,1,283
2025-09-29T04:27:33Z,sentiment,gpt-4.1-mini,1408,177,1585
2025-09-29T04:27:48Z,pre_sentiment,gpt-4.1-mini,301,1,302
2025-09-29T04:27:50Z,sentiment,gpt-4.1-mini,1079,127,1206
2025-09-29T04:27:50Z,pre_sentiment,gpt-4.1-mini,296,1,297
2025-09-29T04:27:52Z,sentiment,gpt-4.1-mini,913,102,1015
2025-09-29T04:27:52Z,pre_sentiment,gpt-4.1-mini,301,1,302
2025-09-29T04:27:55Z,sentiment,gpt-4.1-mini,1339,169,1508
2025-09-29T04:27:55Z,pre_sentiment,gpt-4.1-mini,301,1,302
2025-09-29T04:27:58Z,sentiment,gpt-4.1-mini,1659,193,1852
2025-09-29T04:27:58Z,pre_sentiment,gpt-4.1-mini,295,1,296
2025-09-29T04:28:00Z,sentiment,gpt-4.1-mini,1430,144,1574
2025-09-29T04:28:00Z,pre_sentiment,gpt-4.1-mini,294,1,295
2025-09-29T04:28:03Z,sentiment,gpt-4.1-mini,909,98,1007
2025-09-29T04:28:03Z,pre_sentiment,gpt-4.1-mini,299,1,300
2025-09-29T04:28:04Z,sentiment,gpt-4.1-mini,999,99,1098
2025-09-29T04:28:05Z,pre_sentiment,gpt-4.1-mini,299,1,300
2025-09-29T04:28:07Z,sentiment,gpt-4.1-mini,923,104,1027
2025-09-29T04:28:07Z,pre_sentiment,gpt-4.1-mini,299,1,300
2025-09-29T04:28:09Z,sentiment,gpt-4.1-mini,1681,159,1840
2025-09-29T04:28:35Z,pre_sentiment,gpt-4.1-mini,267,1,268
2025-09-29T04:28:40Z,pre_sentiment,gpt-4.1-mini,279,1,280
2025-09-29T04:28:43Z,pre_sentiment,gpt-4.1-mini,282,1,283
2025-09-29T04:28:46Z,sentiment,gpt-4.1-mini,1436,175,1611
2025-09-29T04:28:56Z,pre_sentiment,gpt-4.1-mini,280,1,281
2025-09-29T04:28:59Z,sentiment,gpt-4.1-mini,1776,238,2014
2025-09-29T04:29:05Z,pre_sentiment,gpt-4.1-mini,292,1,293
2025-09-29T04:29:05Z,pre_sentiment,gpt-4.1-mini,298,1,299
2025-09-29T04:29:08Z,sentiment,gpt-4.1-mini,1320,123,1443
2025-09-29T04:29:39Z,pre_sentiment,gpt-4.1-mini,287,1,288
2025-09-29T04:29:42Z,sentiment,gpt-4.1-mini,1183,148,1331
2025-09-29T04:29:54Z,pre_sentiment,gpt-4.1-mini,286,1,287
2025-09-29T04:29:57Z,sentiment,gpt-4.1-mini,2266,193,2459
2025-09-29T04:30:22Z,article_selection,gpt-4.1-mini,1460,9,1469
2025-09-29T04:30:23Z,article_selection,gpt-4.1-mini,595,13,608
2025-09-29T04:30:23Z,article_selection,gpt-4.1-mini,581,13,594
2025-09-29T04:30:41Z,final_summary_en,gpt-4.1-mini,2129,1228,3357
2025-09-29T04:31:00Z,final_summary_en,gpt-4.1-mini,1180,1172,2352
2025-09-29T04:31:14Z,final_summary_en,gpt-4.1-mini,1301,1032,2333
2025-09-29T04:31:28Z,final_summary_en,gpt-4.1-mini,1492,1148,2640
2025-09-29T04:31:41Z,final_summary_en,gpt-4.1-mini,1329,958,2287
2025-09-29T04:31:57Z,final_summary_en,gpt-4.1-mini,1359,1082,2441
2025-09-29T04:32:14Z,final_summary_en,gpt-4.1-mini,1407,1097,2504
2025-09-29T04:32:32Z,final_summary_en,gpt-4.1-mini,1509,989,2498
2025-09-29T04:32:49Z,final_summary_en,gpt-4.1-mini,1692,1113,2805
2025-09-29T04:33:09Z,final_summary_en,gpt-4.1-mini,2021,1195,3216
2025-09-29T04:33:25Z,final_summary_en,gpt-4.1-mini,1556,1115,2671
2025-09-29T04:33:41Z,final_summary_en,gpt-4.1-mini,1742,974,2716
2025-09-29T04:34:30Z,category_summary,gpt-4.1-mini,117,30,147
2025-09-29T04:34:32Z,category_summary,gpt-4.1-mini,113,27,140
2025-09-29T04:34:34Z,category_summary,gpt-4.1-mini,111,27,138
2025-09-29T04:34:36Z,category_summary,gpt-4.1-mini,88,30,118
2025-09-29T04:34:39Z,category_summary,gpt-4.1-mini,85,19,104
2025-09-29T04:34:39Z,RUN_TOTAL,,74621,17920,92541
2025-09-30T04:25:46Z,pre_sentiment,gpt-4.1-mini,284,1,285
2025-09-30T04:25:47Z,pre_sentiment,gpt-4.1-mini,280,1,281
2025-09-30T04:25:47Z,pre_sentiment,gpt-4.1-mini,284,1,285
2025-09-30T04:25:48Z,pre_sentiment,gpt-4.1-mini,288,1,289
2025-09-30T04:25:49Z,pre_sentiment,gpt-4.1-mini,282,1,283
2025-09-30T04:25:49Z,pre_sentiment,gpt-4.1-mini,280,1,281
2025-09-30T04:25:50Z,pre_sentiment,gpt-4.1-mini,283,1,284
2025-09-30T04:25:50Z,pre_sentiment,gpt-4.1-mini,285,1,286
2025-09-30T04:25:51Z,pre_sentiment,gpt-4.1-mini,279,1,280
2025-09-30T04:25:51Z,pre_sentiment,gpt-4.1-mini,279,1,280
2025-09-30T04:25:54Z,sentiment,gpt-4.1-mini,1901,208,2109
2025-09-30T04:25:54Z,pre_sentiment,gpt-4.1-mini,284,1,285
2025-09-30T04:25:55Z,pre_sentiment,gpt-4.1-mini,283,1,284
2025-09-30T04:25:55Z,pre_sentiment,gpt-4.1-mini,294,1,295
2025-09-30T04:25:56Z,pre_sentiment,gpt-4.1-mini,287,1,288
2025-09-30T04:25:56Z,pre_sentiment,gpt-4.1-mini,284,1,285
2025-09-30T04:25:58Z,sentiment,gpt-4.1-mini,1751,190,1941
2025-09-30T04:26:04Z,pre_sentiment,gpt-4.1-mini,283,1,284
2025-09-30T04:26:04Z,pre_sentiment,gpt-4.1-mini,286,1,287
2025-09-30T04:26:04Z,pre_sentiment,gpt-4.1-mini,281,1,282
2025-09-30T04:26:06Z,sentiment,gpt-4.1-mini,1339,131,1470
2025-09-30T04:26:06Z,pre_sentiment,gpt-4.1-mini,284,1,285
2025-09-30T04:26:07Z,pre_sentiment,gpt-4.1-mini,276,1,277
2025-09-30T04:26:07Z,pre_sentiment,gpt-4.1-mini,285,1,286
2025-09-30T04:26:09Z,sentiment,gpt-4.1-mini,1750,141,1891
2025-09-30T04:26:09Z,pre_sentiment,gpt-4.1-mini,272,1,273
2025-09-30T04:26:17Z,pre_sentiment,gpt-4.1-mini,280,1,281
2025-09-30T04:26:21Z,sentiment,gpt-4.1-mini,2010,196,2206
2025-09-30T04:26:22Z,pre_sentiment,gpt-4.1-mini,287,1,288
2025-09-30T04:26:25Z,sentiment,gpt-4.1-mini,1577,193,1770
2025-09-30T04:26:25Z,pre_sentiment,gpt-4.1-mini,281,1,282
2025-09-30T04:26:28Z,sentiment,gpt-4.1-mini,1956,184,2140
2025-09-30T04:26:28Z,pre_sentiment,gpt-4.1-mini,284,1,285
2025-09-30T04:26:32Z,sentiment,gpt-4.1-mini,1789,232,2021
2025-09-30T04:26:32Z,pre_sentiment,gpt-4.1-mini,283,1,284
2025-09-30T04:26:33Z,pre_sentiment,gpt-4.1-mini,279,1,280
2025-09-30T04:26:36Z,sentiment,gpt-4.1-mini,1560,223,1783
2025-09-30T04:26:36Z,pre_sentiment,gpt-4.1-mini,280,1,281
2025-09-30T04:26:40Z,sentiment,gpt-4.1-mini,1942,196,2138
2025-09-30T04:26:41Z,pre_sentiment,gpt-4.1-mini,289,1,290
2025-09-30T04:26:43Z,sentiment,gpt-4.1-mini,1248,138,1386
2025-09-30T04:26:43Z,pre_sentiment,gpt-4.1-mini,282,1,283
2025-09-30T04:26:46Z,sentiment,gpt-4.1-mini,1933,173,2106
2025-09-30T04:26:46Z,pre_sentiment,gpt-4.1-mini,280,1,281
2025-09-30T04:26:49Z,sentiment,gpt-4.1-mini,2324,180,2504
2025-09-30T04:26:49Z,pre_sentiment,gpt-4.1-mini,293,1,294
2025-09-30T04:26:51Z,sentiment,gpt-4.1-mini,1301,171,1472
2025-09-30T04:26:51Z,pre_sentiment,gpt-4.1-mini,282,1,283
2025-09-30T04:26:54Z,sentiment,gpt-4.1-mini,1757,227,1984
2025-09-30T04:26:54Z,pre_sentiment,gpt-4.1-mini,286,1,287
2025-09-30T04:26:57Z,sentiment,gpt-4.1-mini,2077,189,2266
2025-09-30T04:27:11Z,pre_sentiment,gpt-4.1-mini,306,1,307
2025-09-30T04:27:13Z,sentiment,gpt-4.1-mini,930,89,1019
2025-09-30T04:27:13Z,pre_sentiment,gpt-4.1-mini,304,1,305
2025-09-30T04:27:15Z,sentiment,gpt-4.1-mini,1022,91,1113
2025-09-30T04:27:15Z,pre_sentiment,gpt-4.1-mini,303,1,304
2025-09-30T04:27:17Z,sentiment,gpt-4.1-mini,1120,149,1269
2025-09-30T04:27:17Z,pre_sentiment,gpt-4.1-mini,302,1,303
2025-09-30T04:27:20Z,sentiment,gpt-4.1-mini,3143,200,3343
2025-09-30T04:27:20Z,pre_sentiment,gpt-4.1-mini,300,1,301
2025-09-30T04:27:23Z,sentiment,gpt-4.1-mini,1598,156,1754
2025-09-30T04:27:23Z,pre_sentiment,gpt-4.1-mini,300,1,301
2025-09-30T04:27:26Z,sentiment,gpt-4.1-mini,2416,196,2612
2025-09-30T04:27:26Z,pre_sentiment,gpt-4.1-mini,295,1,296
2025-09-30T04:27:29Z,sentiment,gpt-4.1-mini,1478,196,1674
2025-09-30T04:27:30Z,pre_sentiment,gpt-4.1-mini,302,1,303
2025-09-30T04:27:32Z,sentiment,gpt-4.1-mini,1428,137,1565
2025-09-30T04:27:32Z,pre_sentiment,gpt-4.1-mini,301,1,302
2025-09-30T04:27:34Z,sentiment,gpt-4.1-mini,2054,140,2194
2025-09-30T04:27:35Z,pre_sentiment,gpt-4.1-mini,301,1,302
2025-09-30T04:27:37Z,sentiment,gpt-4.1-mini,1079,125,1204
2025-09-30T04:27:38Z,pre_sentiment,gpt-4.1-mini,296,1,297
2025-09-30T04:27:40Z,sentiment,gpt-4.1-mini,913,97,1010
2025-09-30T04:27:40Z,pre_sentiment,gpt-4.1-mini,301,1,302
2025-09-30T04:27:43Z,sentiment,gpt-4.1-mini,1339,172,1511
2025-09-30T04:27:43Z,pre_sentiment,gpt-4.1-mini,301,1,302
2025-09-30T04:27:46Z,sentiment,gpt-4.1-mini,1670,203,1873
2025-09-30T04:27:47Z,pre_sentiment,gpt-4.1-mini,295,1,296
2025-09-30T04:27:49Z,sentiment,gpt-4.1-mini,1430,174,1604
2025-09-30T04:28:06Z,pre_sentiment,gpt-4.1-mini,288,1,289
2025-09-30T04:28:08Z,sentiment,gpt-4.1-mini,1567,125,1692
2025-09-30T04:28:09Z,pre_sentiment,gpt-4.1-mini,278,1,279
2025-09-30T04:28:11Z,sentiment,gpt-4.1-mini,1188,143,1331
2025-09-30T04:28:11Z,pre_sentiment,gpt-4.1-mini,300,1,301
2025-09-30T04:28:14Z,sentiment,gpt-4.1-mini,1479,196,1675
2025-09-30T04:28:14Z,pre_sentiment,gpt-4.1-mini,286,1,287
2025-09-30T04:28:16Z,sentiment,gpt-4.1-mini,1278,155,1433
2025-09-30T04:28:17Z,pre_sentiment,gpt-4.1-mini,286,1,287
2025-09-30T04:28:20Z,sentiment,gpt-4.1-mini,1935,182,2117
2025-09-30T04:28:20Z,pre_sentiment,gpt-4.1-mini,282,1,283
2025-09-30T04:28:23Z,sentiment,gpt-4.1-mini,2004,170,2174
2025-09-30T04:28:28Z,pre_sentiment,gpt-4.1-mini,290,1,291
2025-09-30T04:28:31Z,sentiment,gpt-4.1-mini,1440,179,1619
2025-09-30T04:28:31Z,pre_sentiment,gpt-4.1-mini,287,1,288
2025-09-30T04:28:34Z,sentiment,gpt-4.1-mini,2663,187,2850
2025-09-30T04:28:52Z,pre_sentiment,gpt-4.1-mini,264,1,265
2025-09-30T04:28:55Z,sentiment,gpt-4.1-mini,2126,234,2360
2025-09-30T04:28:56Z,pre_sentiment,gpt-4.1-mini,285,1,286
2025-09-30T04:28:56Z,pre_sentiment,gpt-4.1-mini,267,1,268
2025-09-30T04:29:00Z,sentiment,gpt-4.1-mini,2131,241,2372
2025-09-30T04:29:05Z,pre_sentiment,gpt-4.1-mini,277,1,278
2025-09-30T04:29:08Z,sentiment,gpt-4.1-mini,1792,215,2007
2025-09-30T04:29:09Z,pre_sentiment,gpt-4.1-mini,279,1,280
2025-09-30T04:29:10Z,pre_sentiment,gpt-4.1-mini,275,1,276
2025-09-30T04:29:12Z,sentiment,gpt-4.1-mini,2910,193,3103
2025-09-30T04:29:12Z,pre_sentiment,gpt-4.1-mini,277,1,278
2025-09-30T04:29:14Z,sentiment,gpt-4.1-mini,2549,101,2650
2025-09-30T04:29:14Z,pre_sentiment,gpt-4.1-mini,274,1,275
2025-09-30T04:29:18Z,pre_sentiment,gpt-4.1-mini,287,1,288
2025-09-30T04:29:20Z,sentiment,gpt-4.1-mini,1496,171,1667
2025-09-30T04:29:20Z,pre_sentiment,gpt-4.1-mini,287,1,288
2025-09-30T04:29:23Z,sentiment,gpt-4.1-mini,1535,187,1722
2025-09-30T04:29:23Z,pre_sentiment,gpt-4.1-mini,288,1,289
2025-09-30T04:29:27Z,sentiment,gpt-4.1-mini,4083,225,4308
2025-09-30T04:29:27Z,pre_sentiment,gpt-4.1-mini,284,1,285
2025-09-30T04:29:29Z,sentiment,gpt-4.1-mini,1531,198,1729
2025-09-30T04:29:29Z,pre_sentiment,gpt-4.1-mini,286,1,287
2025-09-30T04:29:36Z,sentiment,gpt-4.1-mini,2911,205,3116
2025-09-30T04:29:36Z,pre_sentiment,gpt-4.1-mini,284,1,285
2025-09-30T04:29:38Z,sentiment,gpt-4.1-mini,1736,198,1934
2025-09-30T04:29:39Z,pre_sentiment,gpt-4.1-mini,284,1,285
2025-09-30T04:29:41Z,sentiment,gpt-4.1-mini,1583,193,1776
2025-09-30T04:29:51Z,pre_sentiment,gpt-4.1-mini,289,1,290
2025-09-30T04:29:54Z,sentiment,gpt-4.1-mini,1063,158,1221
2025-09-30T04:30:05Z,pre_sentiment,gpt-4.1-mini,289,1,290
2025-09-30T04:30:06Z,sentiment,gpt-4.1-mini,1215,102,1317
2025-09-30T04:30:06Z,pre_sentiment,gpt-4.1-mini,289,1,290
2025-09-30T04:30:10Z,sentiment,gpt-4.1-mini,1695,178,1873
2025-09-30T04:30:33Z,pre_sentiment,gpt-4.1-mini,294,1,295
2025-09-30T04:30:36Z,sentiment,gpt-4.1-mini,1588,191,1779
2025-09-30T04:30:36Z,pre_sentiment,gpt-4.1-mini,285,1,286
2025-09-30T04:30:40Z,sentiment,gpt-4.1-mini,1501,221,1722
2025-09-30T04:30:40Z,pre_sentiment,gpt-4.1-mini,284,1,285
2025-09-30T04:30:43Z,sentiment,gpt-4.1-mini,1549,201,1750
2025-09-30T04:30:43Z,pre_sentiment,gpt-4.1-mini,293,1,294
2025-09-30T04:30:45Z,sentiment,gpt-4.1-mini,1936,144,2080
2025-09-30T04:31:00Z,pre_sentiment,gpt-4.1-mini,282,1,283
2025-09-30T04:31:00Z,pre_sentiment,gpt-4.1-mini,286,1,287
2025-09-30T04:31:00Z,pre_sentiment,gpt-4.1-mini,296,1,297
2025-09-30T04:31:01Z,pre_sentiment,gpt-4.1-mini,286,1,287
2025-09-30T04:31:01Z,pre_sentiment,gpt-4.1-mini,281,1,282
2025-09-30T04:31:04Z,sentiment,gpt-4.1-mini,1259,226,1485
2025-09-30T04:31:05Z,pre_sentiment,gpt-4.1-mini,282,1,283
2025-09-30T04:31:05Z,pre_sentiment,gpt-4.1-mini,289,1,290
2025-09-30T04:31:05Z,pre_sentiment,gpt-4.1-mini,288,1,289
2025-09-30T04:31:06Z,pre_sentiment,gpt-4.1-mini,280,1,281
2025-09-30T04:31:06Z,pre_sentiment,gpt-4.1-mini,280,1,281
2025-09-30T04:31:16Z,pre_sentiment,gpt-4.1-mini,288,1,289
2025-09-30T04:31:19Z,sentiment,gpt-4.1-mini,1799,197,1996
2025-09-30T04:31:19Z,pre_sentiment,gpt-4.1-mini,281,1,282
2025-09-30T04:31:23Z,sentiment,gpt-4.1-mini,2165,250,2415
2025-09-30T04:31:24Z,pre_sentiment,gpt-4.1-mini,288,1,289
2025-09-30T04:31:27Z,sentiment,gpt-4.1-mini,2269,222,2491
2025-09-30T04:31:38Z,pre_sentiment,gpt-4.1-mini,291,1,292
2025-09-30T04:31:38Z,pre_sentiment,gpt-4.1-mini,294,1,295
2025-09-30T04:31:41Z,sentiment,gpt-4.1-mini,1462,195,1657
2025-09-30T04:31:41Z,pre_sentiment,gpt-4.1-mini,286,1,287
2025-09-30T04:31:44Z,sentiment,gpt-4.1-mini,1089,198,1287
2025-09-30T04:31:44Z,pre_sentiment,gpt-4.1-mini,290,1,291
2025-09-30T04:31:47Z,sentiment,gpt-4.1-mini,1515,200,1715
2025-09-30T04:31:47Z,pre_sentiment,gpt-4.1-mini,292,1,293
2025-09-30T04:31:51Z,sentiment,gpt-4.1-mini,1431,212,1643
2025-09-30T04:31:51Z,pre_sentiment,gpt-4.1-mini,282,1,283
2025-09-30T04:31:51Z,pre_sentiment,gpt-4.1-mini,281,1,282
2025-09-30T04:31:54Z,sentiment,gpt-4.1-mini,1394,194,1588
2025-09-30T04:31:54Z,pre_sentiment,gpt-4.1-mini,278,1,279
2025-09-30T04:32:02Z,article_selection,gpt-4.1-mini,2021,12,2033
2025-09-30T04:32:02Z,article_selection,gpt-4.1-mini,708,12,720
2025-09-30T04:32:02Z,article_selection,gpt-4.1-mini,950,12,962
2025-09-30T04:32:03Z,article_selection,gpt-4.1-mini,1596,16,1612
2025-09-30T04:32:03Z,article_selection,gpt-4.1-mini,1221,12,1233
2025-09-30T04:32:20Z,final_summary_en,gpt-4.1-mini,1557,1178,2735
2025-09-30T04:32:32Z,final_summary_en,gpt-4.1-mini,1343,963,2306
2025-09-30T04:32:47Z,final_summary_en,gpt-4.1-mini,1691,1177,2868
2025-09-30T04:33:05Z,final_summary_en,gpt-4.1-mini,1285,1132,2417
2025-09-30T04:33:19Z,final_summary_en,gpt-4.1-mini,2058,1059,3117
2025-09-30T04:33:43Z,final_summary_en,gpt-4.1-mini,1329,1146,2475
2025-09-30T04:33:57Z,final_summary_en,gpt-4.1-mini,1655,873,2528
2025-09-30T04:34:21Z,final_summary_en,gpt-4.1-mini,3848,1491,5339
2025-09-30T04:34:36Z,final_summary_en,gpt-4.1-mini,1535,1129,2664
2025-09-30T04:34:51Z,final_summary_en,gpt-4.1-mini,1235,1015,2250
2025-09-30T04:35:07Z,final_summary_en,gpt-4.1-mini,2681,1093,3774
2025-09-30T04:35:24Z,final_summary_en,gpt-4.1-mini,1510,1211,2721
2025-09-30T04:35:43Z,final_summary_en,gpt-4.1-mini,1891,1195,3086
2025-09-30T04:36:00Z,final_summary_en,gpt-4.1-mini,1250,1143,2393
2025-09-30T04:36:20Z,final_summary_en,gpt-4.1-mini,1288,1173,2461
2025-09-30T04:36:35Z,final_summary_en,gpt-4.1-mini,1167,1107,2274
2025-09-30T04:36:53Z,final_summary_en,gpt-4.1-mini,1555,1315,2870
2025-09-30T04:37:06Z,final_summary_en,gpt-4.1-mini,1149,975,2124
2025-09-30T04:37:21Z,final_summary_en,gpt-4.1-mini,1675,1276,2951
2025-09-30T04:37:44Z,final_summary_en,gpt-4.1-mini,1031,1009,2040
2025-09-30T04:38:00Z,final_summary_en,gpt-4.1-mini,1273,1036,2309
2025-09-30T04:38:15Z,final_summary_en,gpt-4.1-mini,1039,984,2023
2025-09-30T04:39:40Z,category_summary,gpt-4.1-mini,119,27,146
2025-09-30T04:39:41Z,category_summary,gpt-4.1-mini,134,24,158
2025-09-30T04:39:43Z,category_summary,gpt-4.1-mini,129,36,165
2025-09-30T04:39:46Z,category_summary,gpt-4.1-mini,129,37,166
2025-09-30T04:39:48Z,category_summary,gpt-4.1-mini,134,32,166
2025-09-30T04:39:50Z,category_summary,gpt-4.1-mini,92,31,123
2025-09-30T04:39:51Z,RUN_TOTAL,,185615,36915,222530
2025-10-01T04:24:56Z,pre_sentiment,gpt-4.1-mini,290,1,291
2025-10-01T04:24:57Z,pre_sentiment,gpt-4.1-mini,285,1,286
2025-10-01T04:24:58Z,pre_sentiment,gpt-4.1-mini,283,1,284
2025-10-01T04:24:59Z,pre_sentiment,gpt-4.1-mini,283,1,284
2025-10-01T04:25:01Z,sentiment,gpt-4.1-mini,1236,172,1408
2025-10-01T04:25:02Z,pre_sentiment,gpt-4.1-mini,288,1,289
2025-10-01T04:25:02Z,pre_sentiment,gpt-4.1-mini,287,1,288
2025-10-01T04:25:03Z,pre_sentiment,gpt-4.1-mini,289,1,290
2025-10-01T04:25:04Z,pre_sentiment,gpt-4.1-mini,282,1,283
2025-10-01T04:25:04Z,pre_sentiment,gpt-4.1-mini,276,1,277
2025-10-01T04:25:07Z,sentiment,gpt-4.1-mini,1190,176,1366
2025-10-01T04:25:07Z,pre_sentiment,gpt-4.1-mini,281,1,282
2025-10-01T04:25:08Z,pre_sentiment,gpt-4.1-mini,276,1,277
2025-10-01T04:25:08Z,pre_sentiment,gpt-4.1-mini,284,1,285
2025-10-01T04:25:08Z,pre_sentiment,gpt-4.1-mini,288,1,289
2025-10-01T04:25:08Z,pre_sentiment,gpt-4.1-mini,286,1,287
2025-10-01T04:25:16Z,pre_sentiment,gpt-4.1-mini,294,1,295
2025-10-01T04:25:18Z,sentiment,gpt-4.1-mini,1367,149,1516
2025-10-01T04:25:18Z,pre_sentiment,gpt-4.1-mini,286,1,287
2025-10-01T04:25:19Z,pre_sentiment,gpt-4.1-mini,287,1,288
2025-10-01T04:25:19Z,pre_sentiment,gpt-4.1-mini,280,1,281
2025-10-01T04:25:34Z,pre_sentiment,gpt-4.1-mini,280,1,281
2025-10-01T04:25:35Z,pre_sentiment,gpt-4.1-mini,283,1,284
2025-10-01T04:25:39Z,sentiment,gpt-4.1-mini,1706,194,1900
2025-10-01T04:25:39Z,pre_sentiment,gpt-4.1-mini,282,1,283
2025-10-01T04:25:39Z,pre_sentiment,gpt-4.1-mini,281,1,282
2025-10-01T04:25:43Z,sentiment,gpt-4.1-mini,2035,213,2248
2025-10-01T04:25:44Z,pre_sentiment,gpt-4.1-mini,283,1,284
2025-10-01T04:25:47Z,sentiment,gpt-4.1-mini,2122,209,2331
2025-10-01T04:25:48Z,pre_sentiment,gpt-4.1-mini,284,1,285
2025-10-01T04:25:54Z,sentiment,gpt-4.1-mini,1339,208,1547
2025-10-01T04:25:54Z,pre_sentiment,gpt-4.1-mini,280,1,281
2025-10-01T04:25:57Z,sentiment,gpt-4.1-mini,2010,208,2218
2025-10-01T04:25:58Z,pre_sentiment,gpt-4.1-mini,281,1,282
2025-10-01T04:26:00Z,sentiment,gpt-4.1-mini,1956,168,2124
2025-10-01T04:26:15Z,pre_sentiment,gpt-4.1-mini,296,1,297
2025-10-01T04:26:17Z,sentiment,gpt-4.1-mini,984,86,1070
2025-10-01T04:26:17Z,pre_sentiment,gpt-4.1-mini,294,1,295
2025-10-01T04:26:19Z,sentiment,gpt-4.1-mini,905,89,994
2025-10-01T04:26:20Z,pre_sentiment,gpt-4.1-mini,295,1,296
2025-10-01T04:26:22Z,sentiment,gpt-4.1-mini,986,160,1146
2025-10-01T04:26:22Z,pre_sentiment,gpt-4.1-mini,295,1,296
2025-10-01T04:26:24Z,sentiment,gpt-4.1-mini,915,88,1003
2025-10-01T04:26:24Z,pre_sentiment,gpt-4.1-mini,292,1,293
2025-10-01T04:26:26Z,sentiment,gpt-4.1-mini,909,106,1015
2025-10-01T04:26:26Z,pre_sentiment,gpt-4.1-mini,299,1,300
2025-10-01T04:26:28Z,sentiment,gpt-4.1-mini,913,94,1007
2025-10-01T04:26:28Z,pre_sentiment,gpt-4.1-mini,296,1,297
2025-10-01T04:26:30Z,sentiment,gpt-4.1-mini,917,114,1031
2025-10-01T04:26:30Z,pre_sentiment,gpt-4.1-mini,298,1,299
2025-10-01T04:26:32Z,sentiment,gpt-4.1-mini,968,137,1105
2025-10-01T04:26:33Z,pre_sentiment,gpt-4.1-mini,299,1,300
2025-10-01T04:26:35Z,sentiment,gpt-4.1-mini,1532,161,1693
2025-10-01T04:26:35Z,pre_sentiment,gpt-4.1-mini,295,1,296
2025-10-01T04:26:38Z,sentiment,gpt-4.1-mini,2546,181,2727
2025-10-01T04:26:39Z,pre_sentiment,gpt-4.1-mini,299,1,300
2025-10-01T04:26:43Z,sentiment,gpt-4.1-mini,2575,166,2741
2025-10-01T04:26:53Z,pre_sentiment,gpt-4.1-mini,299,1,300
2025-10-01T04:26:55Z,sentiment,gpt-4.1-mini,1003,139,1142
2025-10-01T04:26:58Z,pre_sentiment,gpt-4.1-mini,306,1,307
2025-10-01T04:27:00Z,sentiment,gpt-4.1-mini,930,79,1009
2025-10-01T04:27:01Z,pre_sentiment,gpt-4.1-mini,304,1,305
2025-10-01T04:27:02Z,sentiment,gpt-4.1-mini,1022,88,1110
2025-10-01T04:27:02Z,pre_sentiment,gpt-4.1-mini,303,1,304
2025-10-01T04:27:05Z,sentiment,gpt-4.1-mini,1120,169,1289
2025-10-01T04:27:17Z,pre_sentiment,gpt-4.1-mini,282,1,283
2025-10-01T04:27:20Z,sentiment,gpt-4.1-mini,1167,172,1339
2025-10-01T04:27:24Z,pre_sentiment,gpt-4.1-mini,287,1,288
2025-10-01T04:27:28Z,sentiment,gpt-4.1-mini,1836,217,2053
2025-10-01T04:27:28Z,pre_sentiment,gpt-4.1-mini,284,1,285
2025-10-01T04:27:30Z,sentiment,gpt-4.1-mini,1387,133,1520
2025-10-01T04:27:31Z,pre_sentiment,gpt-4.1-mini,278,1,279
2025-10-01T04:27:33Z,sentiment,gpt-4.1-mini,1633,180,1813
2025-10-01T04:27:33Z,pre_sentiment,gpt-4.1-mini,290,1,291
2025-10-01T04:27:36Z,sentiment,gpt-4.1-mini,1760,166,1926
2025-10-01T04:27:36Z,pre_sentiment,gpt-4.1-mini,281,1,282
2025-10-01T04:27:39Z,sentiment,gpt-4.1-mini,2203,207,2410
2025-10-01T04:27:39Z,pre_sentiment,gpt-4.1-mini,285,1,286
2025-10-01T04:27:43Z,sentiment,gpt-4.1-mini,1529,157,1686
2025-10-01T04:27:43Z,pre_sentiment,gpt-4.1-mini,260,1,261
2025-10-01T04:27:44Z,pre_sentiment,gpt-4.1-mini,295,1,296
2025-10-01T04:27:46Z,sentiment,gpt-4.1-mini,977,117,1094
2025-10-01T04:27:46Z,pre_sentiment,gpt-4.1-mini,299,1,300
2025-10-01T04:27:50Z,sentiment,gpt-4.1-mini,2183,221,2404
2025-10-01T04:27:50Z,pre_sentiment,gpt-4.1-mini,285,1,286
2025-10-01T04:27:52Z,sentiment,gpt-4.1-mini,1129,152,1281
2025-10-01T04:28:01Z,pre_sentiment,gpt-4.1-mini,283,1,284
2025-10-01T04:28:04Z,sentiment,gpt-4.1-mini,2043,181,2224
2025-10-01T04:28:05Z,pre_sentiment,gpt-4.1-mini,280,1,281
2025-10-01T04:28:08Z,sentiment,gpt-4.1-mini,1775,178,1953
2025-10-01T04:28:12Z,pre_sentiment,gpt-4.1-mini,286,1,287
2025-10-01T04:28:12Z,pre_sentiment,gpt-4.1-mini,290,1,291
2025-10-01T04:28:17Z,pre_sentiment,gpt-4.1-mini,273,1,274
2025-10-01T04:28:17Z,pre_sentiment,gpt-4.1-mini,277,1,278
2025-10-01T04:28:18Z,pre_sentiment,gpt-4.1-mini,276,1,277
2025-10-01T04:28:18Z,pre_sentiment,gpt-4.1-mini,275,1,276
2025-10-01T04:28:22Z,pre_sentiment,gpt-4.1-mini,280,1,281
2025-10-01T04:28:25Z,sentiment,gpt-4.1-mini,1592,184,1776
2025-10-01T04:28:25Z,pre_sentiment,gpt-4.1-mini,283,1,284
2025-10-01T04:28:28Z,sentiment,gpt-4.1-mini,1713,198,1911
2025-10-01T04:28:29Z,pre_sentiment,gpt-4.1-mini,285,1,286
2025-10-01T04:28:32Z,sentiment,gpt-4.1-mini,1510,176,1686
2025-10-01T04:28:32Z,pre_sentiment,gpt-4.1-mini,283,1,284
2025-10-01T04:28:36Z,sentiment,gpt-4.1-mini,4448,207,4655
2025-10-01T04:28:37Z,pre_sentiment,gpt-4.1-mini,289,1,290
2025-10-01T04:28:39Z,sentiment,gpt-4.1-mini,1557,179,1736
2025-10-01T04:28:53Z,pre_sentiment,gpt-4.1-mini,290,1,291
2025-10-01T04:28:54Z,pre_sentiment,gpt-4.1-mini,295,1,296
2025-10-01T04:28:56Z,sentiment,gpt-4.1-mini,1098,146,1244
2025-10-01T04:29:19Z,pre_sentiment,gpt-4.1-mini,294,1,295
2025-10-01T04:29:22Z,sentiment,gpt-4.1-mini,1588,175,1763
2025-10-01T04:29:35Z,pre_sentiment,gpt-4.1-mini,285,1,286
2025-10-01T04:29:38Z,sentiment,gpt-4.1-mini,1539,213,1752
2025-10-01T04:29:39Z,pre_sentiment,gpt-4.1-mini,289,1,290
2025-10-01T04:29:39Z,pre_sentiment,gpt-4.1-mini,286,1,287
2025-10-01T04:29:39Z,pre_sentiment,gpt-4.1-mini,284,1,285
2025-10-01T04:29:40Z,pre_sentiment,gpt-4.1-mini,283,1,284
2025-10-01T04:29:40Z,pre_sentiment,gpt-4.1-mini,293,1,294
2025-10-01T04:29:40Z,pre_sentiment,gpt-4.1-mini,286,1,287
2025-10-01T04:29:41Z,pre_sentiment,gpt-4.1-mini,285,1,286
2025-10-01T04:29:43Z,sentiment,gpt-4.1-mini,1670,181,1851
2025-10-01T04:29:44Z,pre_sentiment,gpt-4.1-mini,297,1,298
2025-10-01T04:29:56Z,pre_sentiment,gpt-4.1-mini,277,1,278
2025-10-01T04:29:57Z,pre_sentiment,gpt-4.1-mini,289,1,290
2025-10-01T04:30:00Z,sentiment,gpt-4.1-mini,1632,193,1825
2025-10-01T04:30:01Z,pre_sentiment,gpt-4.1-mini,288,1,289
2025-10-01T04:30:04Z,sentiment,gpt-4.1-mini,1808,200,2008
2025-10-01T04:30:16Z,pre_sentiment,gpt-4.1-mini,285,1,286
2025-10-01T04:30:18Z,sentiment,gpt-4.1-mini,1089,130,1219
2025-10-01T04:30:18Z,pre_sentiment,gpt-4.1-mini,285,1,286
2025-10-01T04:30:21Z,sentiment,gpt-4.1-mini,1240,177,1417
2025-10-01T04:30:21Z,pre_sentiment,gpt-4.1-mini,290,1,291
2025-10-01T04:30:24Z,sentiment,gpt-4.1-mini,1394,184,1578
2025-10-01T04:30:25Z,pre_sentiment,gpt-4.1-mini,283,1,284
2025-10-01T04:30:25Z,pre_sentiment,gpt-4.1-mini,295,1,296
2025-10-01T04:30:25Z,pre_sentiment,gpt-4.1-mini,282,1,283
2025-10-01T04:30:28Z,sentiment,gpt-4.1-mini,1066,166,1232
2025-10-01T04:30:29Z,pre_sentiment,gpt-4.1-mini,286,1,287
2025-10-01T04:30:31Z,sentiment,gpt-4.1-mini,1185,145,1330
2025-10-01T04:30:31Z,pre_sentiment,gpt-4.1-mini,280,1,281
2025-10-01T04:30:31Z,pre_sentiment,gpt-4.1-mini,276,1,277
2025-10-01T04:30:32Z,pre_sentiment,gpt-4.1-mini,273,1,274
2025-10-01T04:30:32Z,pre_sentiment,gpt-4.1-mini,279,1,280
2025-10-01T04:30:32Z,pre_sentiment,gpt-4.1-mini,289,1,290
2025-10-01T04:30:35Z,sentiment,gpt-4.1-mini,2411,192,2603
2025-10-01T04:30:49Z,article_selection,gpt-4.1-mini,1345,12,1357
2025-10-01T04:30:49Z,article_selection,gpt-4.1-mini,1116,12,1128
2025-10-01T04:30:49Z,article_selection,gpt-4.1-mini,909,9,918
2025-10-01T04:30:50Z,article_selection,gpt-4.1-mini,508,13,521
2025-10-01T04:30:51Z,article_selection,gpt-4.1-mini,697,12,709
2025-10-01T04:30:51Z,article_selection,gpt-4.1-mini,392,6,398
2025-10-01T04:31:14Z,final_summary_en,gpt-4.1-mini,1874,1292,3166
2025-10-01T04:31:33Z,final_summary_en,gpt-4.1-mini,1424,1095,2519
2025-10-01T04:31:48Z,final_summary_en,gpt-4.1-mini,1696,1082,2778
2025-10-01T04:32:10Z,final_summary_en,gpt-4.1-mini,4206,1284,5490
2025-10-01T04:32:28Z,final_summary_en,gpt-4.1-mini,1465,1110,2575
2025-10-01T04:32:42Z,final_summary_en,gpt-4.1-mini,910,923,1833
2025-10-01T04:32:58Z,final_summary_en,gpt-4.1-mini,1560,1140,2700
2025-10-01T04:33:14Z,final_summary_en,gpt-4.1-mini,1791,1052,2843
2025-10-01T04:33:35Z,final_summary_en,gpt-4.1-mini,1798,1135,2933
2025-10-01T04:33:53Z,final_summary_en,gpt-4.1-mini,1606,1198,2804
2025-10-01T04:34:12Z,final_summary_en,gpt-4.1-mini,1959,1291,3250
2025-10-01T04:34:32Z,final_summary_en,gpt-4.1-mini,1953,1115,3068
2025-10-01T04:34:46Z,final_summary_en,gpt-4.1-mini,1096,898,1994
2025-10-01T04:35:01Z,final_summary_en,gpt-4.1-mini,723,1000,1723
2025-10-01T04:35:16Z,final_summary_en,gpt-4.1-mini,933,984,1917
2025-10-01T04:35:34Z,final_summary_en,gpt-4.1-mini,1293,1052,2345
2025-10-01T04:35:53Z,final_summary_en,gpt-4.1-mini,2156,1410,3566
2025-10-01T04:36:08Z,final_summary_en,gpt-4.1-mini,1396,820,2216
2025-10-01T04:36:26Z,final_summary_en,gpt-4.1-mini,976,987,1963
2025-10-01T04:36:43Z,final_summary_en,gpt-4.1-mini,1246,1085,2331
2025-10-01T04:36:59Z,final_summary_en,gpt-4.1-mini,804,913,1717
2025-10-01T04:38:11Z,category_summary,gpt-4.1-mini,129,32,161
2025-10-01T04:38:13Z,category_summary,gpt-4.1-mini,127,33,160
2025-10-01T04:38:15Z,category_summary,gpt-4.1-mini,112,36,148
2025-10-01T04:38:17Z,category_summary,gpt-4.1-mini,135,40,175
2025-10-01T04:38:19Z,category_summary,gpt-4.1-mini,129,25,154
2025-10-01T04:38:21Z,category_summary,gpt-4.1-mini,98,20,118
2025-10-01T04:38:22Z,RUN_TOTAL,,146269,31889,178158
2025-10-02T04:24:47Z,pre_sentiment,gpt-4.1-mini,285,1,286
2025-10-02T04:24:48Z,pre_sentiment,gpt-4.1-mini,279,1,280
2025-10-02T04:24:49Z,pre_sentiment,gpt-4.1-mini,288,1,289
2025-10-02T04:24:49Z,pre_sentiment,gpt-4.1-mini,282,1,283
2025-10-02T04:24:53Z,sentiment,gpt-4.1-mini,1831,188,2019
2025-10-02T04:24:53Z,pre_sentiment,gpt-4.1-mini,282,1,283
2025-10-02T04:24:54Z,pre_sentiment,gpt-4.1-mini,290,1,291
2025-10-02T04:24:54Z,pre_sentiment,gpt-4.1-mini,287,1,288
2025-10-02T04:24:56Z,pre_sentiment,gpt-4.1-mini,281,1,282
2025-10-02T04:24:56Z,pre_sentiment,gpt-4.1-mini,282,1,283
2025-10-02T04:24:57Z,pre_sentiment,gpt-4.1-mini,278,1,279
2025-10-02T04:24:57Z,pre_sentiment,gpt-4.1-mini,278,1,279
2025-10-02T04:25:01Z,sentiment,gpt-4.1-mini,1243,204,1447
2025-10-02T04:25:02Z,pre_sentiment,gpt-4.1-mini,282,1,283
2025-10-02T04:25:02Z,pre_sentiment,gpt-4.1-mini,292,1,293
2025-10-02T04:25:03Z,pre_sentiment,gpt-4.1-mini,284,1,285
2025-10-02T04:25:06Z,sentiment,gpt-4.1-mini,1461,184,1645
2025-10-02T04:25:07Z,pre_sentiment,gpt-4.1-mini,285,1,286
2025-10-02T04:25:12Z,pre_sentiment,gpt-4.1-mini,282,1,283
2025-10-02T04:25:13Z,pre_sentiment,gpt-4.1-mini,278,1,279
2025-10-02T04:25:14Z,pre_sentiment,gpt-4.1-mini,282,1,283
2025-10-02T04:25:14Z,pre_sentiment,gpt-4.1-mini,287,1,288
2025-10-02T04:25:14Z,pre_sentiment,gpt-4.1-mini,284,1,285
2025-10-02T04:25:22Z,pre_sentiment,gpt-4.1-mini,281,1,282
2025-10-02T04:25:23Z,pre_sentiment,gpt-4.1-mini,286,1,287
2025-10-02T04:25:26Z,sentiment,gpt-4.1-mini,1807,194,2001
2025-10-02T04:25:27Z,pre_sentiment,gpt-4.1-mini,286,1,287
2025-10-02T04:25:31Z,sentiment,gpt-4.1-mini,2161,182,2343
2025-10-02T04:25:32Z,pre_sentiment,gpt-4.1-mini,284,1,285
2025-10-02T04:25:36Z,sentiment,gpt-4.1-mini,1393,208,1601
2025-10-02T04:25:36Z,pre_sentiment,gpt-4.1-mini,282,1,283
2025-10-02T04:25:42Z,sentiment,gpt-4.1-mini,2244,222,2466
2025-10-02T04:25:42Z,pre_sentiment,gpt-4.1-mini,281,1,282
2025-10-02T04:25:46Z,sentiment,gpt-4.1-mini,1371,219,1590
2025-10-02T04:25:46Z,pre_sentiment,gpt-4.1-mini,283,1,284
2025-10-02T04:25:47Z,pre_sentiment,gpt-4.1-mini,289,1,290
2025-10-02T04:25:50Z,sentiment,gpt-4.1-mini,2145,226,2371
2025-10-02T04:25:51Z,pre_sentiment,gpt-4.1-mini,285,1,286
2025-10-02T04:25:54Z,sentiment,gpt-4.1-mini,2400,216,2616
2025-10-02T04:25:54Z,pre_sentiment,gpt-4.1-mini,285,1,286
2025-10-02T04:25:58Z,sentiment,gpt-4.1-mini,2253,207,2460
2025-10-02T04:26:18Z,pre_sentiment,gpt-4.1-mini,313,1,314
2025-10-02T04:26:19Z,sentiment,gpt-4.1-mini,940,84,1024
2025-10-02T04:26:20Z,pre_sentiment,gpt-4.1-mini,292,1,293
2025-10-02T04:26:24Z,sentiment,gpt-4.1-mini,1345,199,1544
2025-10-02T04:26:24Z,pre_sentiment,gpt-4.1-mini,295,1,296
2025-10-02T04:26:27Z,sentiment,gpt-4.1-mini,983,168,1151
2025-10-02T04:26:27Z,pre_sentiment,gpt-4.1-mini,297,1,298
2025-10-02T04:26:30Z,sentiment,gpt-4.1-mini,1000,154,1154
2025-10-02T04:26:30Z,pre_sentiment,gpt-4.1-mini,292,1,293
2025-10-02T04:26:32Z,sentiment,gpt-4.1-mini,905,105,1010
2025-10-02T04:26:32Z,pre_sentiment,gpt-4.1-mini,298,1,299
2025-10-02T04:26:35Z,sentiment,gpt-4.1-mini,1104,154,1258
2025-10-02T04:26:35Z,pre_sentiment,gpt-4.1-mini,297,1,298
2025-10-02T04:26:40Z,sentiment,gpt-4.1-mini,8665,218,8883
2025-10-02T04:26:41Z,pre_sentiment,gpt-4.1-mini,295,1,296
2025-10-02T04:26:44Z,sentiment,gpt-4.1-mini,1146,184,1330
2025-10-02T04:26:44Z,pre_sentiment,gpt-4.1-mini,305,1,306
2025-10-02T04:26:48Z,sentiment,gpt-4.1-mini,4334,202,4536
2025-10-02T04:26:48Z,pre_sentiment,gpt-4.1-mini,308,1,309
2025-10-02T04:26:53Z,sentiment,gpt-4.1-mini,3667,193,3860
2025-10-02T04:26:53Z,pre_sentiment,gpt-4.1-mini,298,1,299
2025-10-02T04:26:56Z,sentiment,gpt-4.1-mini,7906,158,8064
2025-10-02T04:26:57Z,pre_sentiment,gpt-4.1-mini,296,1,297
2025-10-02T04:27:00Z,sentiment,gpt-4.1-mini,2874,187,3061
2025-10-02T04:27:00Z,pre_sentiment,gpt-4.1-mini,297,1,298
2025-10-02T04:27:04Z,sentiment,gpt-4.1-mini,3120,185,3305
2025-10-02T04:27:04Z,pre_sentiment,gpt-4.1-mini,305,1,306
2025-10-02T04:27:08Z,sentiment,gpt-4.1-mini,3899,228,4127
2025-10-02T04:27:09Z,pre_sentiment,gpt-4.1-mini,297,1,298
2025-10-02T04:27:15Z,sentiment,gpt-4.1-mini,8428,214,8642
2025-10-02T04:27:26Z,pre_sentiment,gpt-4.1-mini,284,1,285
2025-10-02T04:27:41Z,pre_sentiment,gpt-4.1-mini,284,1,285
2025-10-02T04:27:43Z,sentiment,gpt-4.1-mini,1615,152,1767
2025-10-02T04:27:51Z,pre_sentiment,gpt-4.1-mini,287,1,288
2025-10-02T04:27:55Z,sentiment,gpt-4.1-mini,3231,241,3472
2025-10-02T04:27:55Z,pre_sentiment,gpt-4.1-mini,267,1,268
2025-10-02T04:27:59Z,sentiment,gpt-4.1-mini,3354,180,3534
2025-10-02T04:28:09Z,pre_sentiment,gpt-4.1-mini,272,1,273
2025-10-02T04:28:09Z,pre_sentiment,gpt-4.1-mini,272,1,273
2025-10-02T04:28:09Z,pre_sentiment,gpt-4.1-mini,273,1,274
2025-10-02T04:28:20Z,pre_sentiment,gpt-4.1-mini,290,1,291
2025-10-02T04:28:20Z,pre_sentiment,gpt-4.1-mini,283,1,284
2025-10-02T04:28:23Z,sentiment,gpt-4.1-mini,1878,202,2080
2025-10-02T04:28:23Z,pre_sentiment,gpt-4.1-mini,282,1,283
2025-10-02T04:28:26Z,sentiment,gpt-4.1-mini,1636,183,1819
2025-10-02T04:28:26Z,pre_sentiment,gpt-4.1-mini,283,1,284
2025-10-02T04:28:29Z,sentiment,gpt-4.1-mini,1369,204,1573
2025-10-02T04:28:30Z,pre_sentiment,gpt-4.1-mini,286,1,287
2025-10-02T04:28:33Z,sentiment,gpt-4.1-mini,3125,212,3337
2025-10-02T04:28:33Z,pre_sentiment,gpt-4.1-mini,283,1,284
2025-10-02T04:28:36Z,sentiment,gpt-4.1-mini,1483,171,1654
2025-10-02T04:28:36Z,pre_sentiment,gpt-4.1-mini,280,1,281
2025-10-02T04:28:41Z,sentiment,gpt-4.1-mini,2655,211,2866
2025-10-02T04:28:41Z,pre_sentiment,gpt-4.1-mini,284,1,285
2025-10-02T04:28:44Z,sentiment,gpt-4.1-mini,2334,161,2495
2025-10-02T04:28:55Z,pre_sentiment,gpt-4.1-mini,290,1,291
2025-10-02T04:28:56Z,pre_sentiment,gpt-4.1-mini,286,1,287
2025-10-02T04:29:08Z,pre_sentiment,gpt-4.1-mini,290,1,291
2025-10-02T04:29:10Z,sentiment,gpt-4.1-mini,1221,128,1349
2025-10-02T04:29:10Z,pre_sentiment,gpt-4.1-mini,290,1,291
2025-10-02T04:29:15Z,pre_sentiment,gpt-4.1-mini,290,1,291
2025-10-02T04:29:15Z,pre_sentiment,gpt-4.1-mini,286,1,287
2025-10-02T04:29:27Z,pre_sentiment,gpt-4.1-mini,286,1,287
2025-10-02T04:29:28Z,pre_sentiment,gpt-4.1-mini,282,1,283
2025-10-02T04:29:30Z,sentiment,gpt-4.1-mini,1009,125,1134
2025-10-02T04:29:30Z,pre_sentiment,gpt-4.1-mini,287,1,288
2025-10-02T04:29:33Z,sentiment,gpt-4.1-mini,1067,154,1221
2025-10-02T04:29:44Z,pre_sentiment,gpt-4.1-mini,284,1,285
2025-10-02T04:29:47Z,sentiment,gpt-4.1-mini,1410,181,1591
2025-10-02T04:29:48Z,pre_sentiment,gpt-4.1-mini,286,1,287
2025-10-02T04:29:50Z,sentiment,gpt-4.1-mini,1836,138,1974
2025-10-02T04:29:59Z,pre_sentiment,gpt-4.1-mini,287,1,288
2025-10-02T04:30:03Z,sentiment,gpt-4.1-mini,1495,197,1692
2025-10-02T04:30:10Z,pre_sentiment,gpt-4.1-mini,282,1,283
2025-10-02T04:30:27Z,pre_sentiment,gpt-4.1-mini,277,1,278
2025-10-02T04:30:41Z,pre_sentiment,gpt-4.1-mini,288,1,289
2025-10-02T04:30:44Z,sentiment,gpt-4.1-mini,1154,192,1346
2025-10-02T04:30:44Z,pre_sentiment,gpt-4.1-mini,287,1,288
2025-10-02T04:30:45Z,pre_sentiment,gpt-4.1-mini,326,1,327
2025-10-02T04:30:48Z,sentiment,gpt-4.1-mini,1010,178,1188
2025-10-02T04:30:48Z,pre_sentiment,gpt-4.1-mini,292,1,293
2025-10-02T04:30:48Z,pre_sentiment,gpt-4.1-mini,295,1,296
2025-10-02T04:30:48Z,pre_sentiment,gpt-4.1-mini,278,1,279
2025-10-02T04:30:49Z,pre_sentiment,gpt-4.1-mini,283,1,284
2025-10-02T04:30:52Z,sentiment,gpt-4.1-mini,1178,220,1398
2025-10-02T04:30:53Z,pre_sentiment,gpt-4.1-mini,281,1,282
2025-10-02T04:30:53Z,pre_sentiment,gpt-4.1-mini,299,1,300
2025-10-02T04:30:53Z,pre_sentiment,gpt-4.1-mini,298,1,299
2025-10-02T04:30:57Z,sentiment,gpt-4.1-mini,1240,209,1449
2025-10-02T04:30:58Z,pre_sentiment,gpt-4.1-mini,277,1,278
2025-10-02T04:31:01Z,sentiment,gpt-4.1-mini,1200,171,1371
2025-10-02T04:31:01Z,pre_sentiment,gpt-4.1-mini,285,1,286
2025-10-02T04:31:05Z,sentiment,gpt-4.1-mini,1491,225,1716
2025-10-02T04:31:06Z,pre_sentiment,gpt-4.1-mini,285,1,286
2025-10-02T04:31:09Z,sentiment,gpt-4.1-mini,1437,191,1628
2025-10-02T04:31:11Z,pre_sentiment,gpt-4.1-mini,282,1,283
2025-10-02T04:31:16Z,sentiment,gpt-4.1-mini,1207,157,1364
2025-10-02T04:31:36Z,article_selection,gpt-4.1-mini,2069,12,2081
2025-10-02T04:31:36Z,article_selection,gpt-4.1-mini,928,12,940
2025-10-02T04:31:37Z,article_selection,gpt-4.1-mini,581,13,594
2025-10-02T04:31:37Z,article_selection,gpt-4.1-mini,983,12,995
2025-10-02T04:31:38Z,article_selection,gpt-4.1-mini,769,9,778
2025-10-02T04:31:39Z,article_selection,gpt-4.1-mini,664,12,676
2025-10-02T04:31:56Z,final_summary_en,gpt-4.1-mini,1557,1076,2633
2025-10-02T04:32:20Z,final_summary_en,gpt-4.1-mini,1135,1032,2167
2025-10-02T04:32:32Z,final_summary_en,gpt-4.1-mini,1100,947,2047
2025-10-02T04:32:45Z,final_summary_en,gpt-4.1-mini,3670,1027,4697
2025-10-02T04:33:03Z,final_summary_en,gpt-4.1-mini,2007,1253,3260
2025-10-02T04:33:21Z,final_summary_en,gpt-4.1-mini,2168,1305,3473
2025-10-02T04:33:32Z,final_summary_en,gpt-4.1-mini,730,931,1661
2025-10-02T04:33:43Z,final_summary_en,gpt-4.1-mini,2875,927,3802
2025-10-02T04:33:56Z,final_summary_en,gpt-4.1-mini,2001,1061,3062
2025-10-02T04:34:16Z,final_summary_en,gpt-4.1-mini,1898,1219,3117
2025-10-02T04:34:33Z,final_summary_en,gpt-4.1-mini,1225,1114,2339
2025-10-02T04:34:45Z,final_summary_en,gpt-4.1-mini,1575,1022,2597
2025-10-02T04:35:03Z,final_summary_en,gpt-4.1-mini,1905,1269,3174
2025-10-02T04:35:18Z,final_summary_en,gpt-4.1-mini,3017,1188,4205
2025-10-02T04:35:32Z,final_summary_en,gpt-4.1-mini,2881,1171,4052
2025-10-02T04:35:45Z,final_summary_en,gpt-4.1-mini,1002,1060,2062
2025-10-02T04:36:01Z,final_summary_en,gpt-4.1-mini,1248,1092,2340
2025-10-02T04:36:18Z,final_summary_en,gpt-4.1-mini,910,1036,1946
2025-10-02T04:36:30Z,final_summary_en,gpt-4.1-mini,1152,989,2141
2025-10-02T04:36:51Z,final_summary_en,gpt-4.1-mini,1265,1232,2497
2025-10-02T04:37:04Z,final_summary_en,gpt-4.1-mini,948,968,1916
2025-10-02T04:37:18Z,final_summary_en,gpt-4.1-mini,1190,962,2152
2025-10-02T04:38:42Z,category_summary,gpt-4.1-mini,127,27,154
2025-10-02T04:38:44Z,category_summary,gpt-4.1-mini,137,40,177
2025-10-02T04:38:46Z,category_summary,gpt-4.1-mini,123,36,159
2025-10-02T04:38:48Z,category_summary,gpt-4.1-mini,142,43,185
2025-10-02T04:38:51Z,category_summary,gpt-4.1-mini,113,32,145
2025-10-02T04:38:53Z,category_summary,gpt-4.1-mini,129,36,165
2025-10-02T04:38:54Z,RUN_TOTAL,,180748,33519,214267
2025-10-03T04:24:25Z,pre_sentiment,gpt-4.1-mini,285,1,286
2025-10-03T04:24:26Z,pre_sentiment,gpt-4.1-mini,278,1,279
2025-10-03T04:24:26Z,pre_sentiment,gpt-4.1-mini,288,1,289
2025-10-03T04:24:27Z,pre_sentiment,gpt-4.1-mini,287,1,288
2025-10-03T04:24:28Z,pre_sentiment,gpt-4.1-mini,282,1,283
2025-10-03T04:24:30Z,sentiment,gpt-4.1-mini,1555,132,1687
2025-10-03T04:24:30Z,pre_sentiment,gpt-4.1-mini,290,1,291
2025-10-03T04:24:33Z,sentiment,gpt-4.1-mini,2227,126,2353
2025-10-03T04:24:34Z,pre_sentiment,gpt-4.1-mini,275,1,276
2025-10-03T04:24:34Z,pre_sentiment,gpt-4.1-mini,275,1,276
2025-10-03T04:24:34Z,pre_sentiment,gpt-4.1-mini,286,1,287
2025-10-03T04:24:35Z,pre_sentiment,gpt-4.1-mini,288,1,289
2025-10-03T04:24:37Z,sentiment,gpt-4.1-mini,1639,142,1781
2025-10-03T04:24:37Z,pre_sentiment,gpt-4.1-mini,278,1,279
2025-10-03T04:24:37Z,pre_sentiment,gpt-4.1-mini,286,1,287
2025-10-03T04:24:38Z,pre_sentiment,gpt-4.1-mini,279,1,280
2025-10-03T04:24:41Z,sentiment,gpt-4.1-mini,2079,164,2243
2025-10-03T04:24:41Z,pre_sentiment,gpt-4.1-mini,284,1,285
2025-10-03T04:24:46Z,pre_sentiment,gpt-4.1-mini,275,1,276
2025-10-03T04:24:46Z,pre_sentiment,gpt-4.1-mini,279,1,280
2025-10-03T04:24:46Z,pre_sentiment,gpt-4.1-mini,278,1,279
2025-10-03T04:24:47Z,pre_sentiment,gpt-4.1-mini,278,1,279
2025-10-03T04:24:56Z,pre_sentiment,gpt-4.1-mini,275,1,276
2025-10-03T04:25:01Z,pre_sentiment,gpt-4.1-mini,281,1,282
2025-10-03T04:25:01Z,pre_sentiment,gpt-4.1-mini,285,1,286
2025-10-03T04:25:05Z,sentiment,gpt-4.1-mini,1518,223,1741
2025-10-03T04:25:06Z,pre_sentiment,gpt-4.1-mini,289,1,290
2025-10-03T04:25:09Z,sentiment,gpt-4.1-mini,1698,216,1914
2025-10-03T04:25:10Z,pre_sentiment,gpt-4.1-mini,278,1,279
2025-10-03T04:25:13Z,sentiment,gpt-4.1-mini,2497,228,2725
2025-10-03T04:25:13Z,pre_sentiment,gpt-4.1-mini,283,1,284
2025-10-03T04:25:14Z,pre_sentiment,gpt-4.1-mini,281,1,282
2025-10-03T04:25:14Z,pre_sentiment,gpt-4.1-mini,291,1,292
2025-10-03T04:25:14Z,pre_sentiment,gpt-4.1-mini,284,1,285
2025-10-03T04:25:18Z,sentiment,gpt-4.1-mini,1902,204,2106
2025-10-03T04:25:32Z,pre_sentiment,gpt-4.1-mini,311,1,312
2025-10-03T04:25:33Z,sentiment,gpt-4.1-mini,933,92,1025
2025-10-03T04:25:33Z,pre_sentiment,gpt-4.1-mini,300,1,301
2025-10-03T04:25:35Z,sentiment,gpt-4.1-mini,1017,92,1109
2025-10-03T04:25:35Z,pre_sentiment,gpt-4.1-mini,303,1,304
2025-10-03T04:25:39Z,sentiment,gpt-4.1-mini,1478,202,1680
2025-10-03T04:25:39Z,pre_sentiment,gpt-4.1-mini,296,1,297
2025-10-03T04:25:42Z,sentiment,gpt-4.1-mini,1913,202,2115
2025-10-03T04:25:42Z,pre_sentiment,gpt-4.1-mini,295,1,296
2025-10-03T04:25:45Z,sentiment,gpt-4.1-mini,1488,155,1643
2025-10-03T04:25:45Z,pre_sentiment,gpt-4.1-mini,294,1,295
2025-10-03T04:25:48Z,sentiment,gpt-4.1-mini,3068,247,3315
2025-10-03T04:25:49Z,pre_sentiment,gpt-4.1-mini,299,1,300
2025-10-03T04:25:49Z,pre_sentiment,gpt-4.1-mini,305,1,306
2025-10-03T04:25:51Z,sentiment,gpt-4.1-mini,1547,137,1684
2025-10-03T04:25:51Z,pre_sentiment,gpt-4.1-mini,302,1,303
2025-10-03T04:25:55Z,sentiment,gpt-4.1-mini,7159,238,7397
2025-10-03T04:25:55Z,pre_sentiment,gpt-4.1-mini,293,1,294
2025-10-03T04:25:56Z,pre_sentiment,gpt-4.1-mini,297,1,298
2025-10-03T04:25:58Z,sentiment,gpt-4.1-mini,3602,165,3767
2025-10-03T04:25:58Z,pre_sentiment,gpt-4.1-mini,313,1,314
2025-10-03T04:26:00Z,sentiment,gpt-4.1-mini,940,90,1030
2025-10-03T04:26:00Z,pre_sentiment,gpt-4.1-mini,295,1,296
2025-10-03T04:26:03Z,sentiment,gpt-4.1-mini,983,166,1149
2025-10-03T04:26:28Z,pre_sentiment,gpt-4.1-mini,275,1,276
2025-10-03T04:26:31Z,sentiment,gpt-4.1-mini,2080,184,2264
2025-10-03T04:26:32Z,pre_sentiment,gpt-4.1-mini,282,1,283
2025-10-03T04:26:35Z,sentiment,gpt-4.1-mini,1704,153,1857
2025-10-03T04:26:59Z,pre_sentiment,gpt-4.1-mini,288,1,289
2025-10-03T04:27:05Z,sentiment,gpt-4.1-mini,6996,230,7226
2025-10-03T04:27:05Z,pre_sentiment,gpt-4.1-mini,263,1,264
2025-10-03T04:27:05Z,pre_sentiment,gpt-4.1-mini,266,1,267
2025-10-03T04:27:06Z,pre_sentiment,gpt-4.1-mini,263,1,264
2025-10-03T04:27:09Z,sentiment,gpt-4.1-mini,2932,232,3164
2025-10-03T04:27:17Z,pre_sentiment,gpt-4.1-mini,271,1,272
2025-10-03T04:27:17Z,pre_sentiment,gpt-4.1-mini,275,1,276
2025-10-03T04:27:17Z,pre_sentiment,gpt-4.1-mini,279,1,280
2025-10-03T04:27:21Z,sentiment,gpt-4.1-mini,1864,241,2105
2025-10-03T04:27:22Z,pre_sentiment,gpt-4.1-mini,276,1,277
2025-10-03T04:27:22Z,pre_sentiment,gpt-4.1-mini,274,1,275
2025-10-03T04:27:22Z,pre_sentiment,gpt-4.1-mini,288,1,289
2025-10-03T04:27:27Z,pre_sentiment,gpt-4.1-mini,287,1,288
2025-10-03T04:27:27Z,pre_sentiment,gpt-4.1-mini,283,1,284
2025-10-03T04:27:27Z,pre_sentiment,gpt-4.1-mini,285,1,286
2025-10-03T04:27:30Z,sentiment,gpt-4.1-mini,1424,181,1605
2025-10-03T04:27:30Z,pre_sentiment,gpt-4.1-mini,290,1,291
2025-10-03T04:27:33Z,sentiment,gpt-4.1-mini,2230,202,2432
2025-10-03T04:27:34Z,pre_sentiment,gpt-4.1-mini,280,1,281
2025-10-03T04:27:37Z,sentiment,gpt-4.1-mini,1625,174,1799
2025-10-03T04:27:43Z,pre_sentiment,gpt-4.1-mini,291,1,292
2025-10-03T04:27:50Z,pre_sentiment,gpt-4.1-mini,294,1,295
2025-10-03T04:27:52Z,sentiment,gpt-4.1-mini,1786,139,1925
2025-10-03T04:27:53Z,pre_sentiment,gpt-4.1-mini,287,1,288
2025-10-03T04:27:57Z,sentiment,gpt-4.1-mini,1152,138,1290
2025-10-03T04:28:01Z,pre_sentiment,gpt-4.1-mini,291,1,292
2025-10-03T04:28:08Z,pre_sentiment,gpt-4.1-mini,298,1,299
2025-10-03T04:28:10Z,sentiment,gpt-4.1-mini,1140,124,1264
2025-10-03T04:28:18Z,pre_sentiment,gpt-4.1-mini,287,1,288
2025-10-03T04:28:20Z,sentiment,gpt-4.1-mini,1414,169,1583
2025-10-03T04:28:20Z,pre_sentiment,gpt-4.1-mini,286,1,287
2025-10-03T04:28:23Z,sentiment,gpt-4.1-mini,1895,212,2107
2025-10-03T04:28:24Z,pre_sentiment,gpt-4.1-mini,283,1,284
2025-10-03T04:28:26Z,sentiment,gpt-4.1-mini,1617,166,1783
2025-10-03T04:28:26Z,pre_sentiment,gpt-4.1-mini,288,1,289
2025-10-03T04:28:30Z,sentiment,gpt-4.1-mini,1707,196,1903
2025-10-03T04:28:40Z,pre_sentiment,gpt-4.1-mini,286,1,287
2025-10-03T04:28:42Z,sentiment,gpt-4.1-mini,1255,107,1362
2025-10-03T04:28:49Z,pre_sentiment,gpt-4.1-mini,288,1,289
2025-10-03T04:28:49Z,pre_sentiment,gpt-4.1-mini,277,1,278
2025-10-03T04:28:49Z,pre_sentiment,gpt-4.1-mini,289,1,290
2025-10-03T04:28:50Z,pre_sentiment,gpt-4.1-mini,287,1,288
2025-10-03T04:28:50Z,pre_sentiment,gpt-4.1-mini,282,1,283
2025-10-03T04:28:50Z,pre_sentiment,gpt-4.1-mini,282,1,283
2025-10-03T04:29:02Z,pre_sentiment,gpt-4.1-mini,288,1,289
2025-10-03T04:29:13Z,pre_sentiment,gpt-4.1-mini,278,1,279
2025-10-03T04:29:13Z,pre_sentiment,gpt-4.1-mini,291,1,292
2025-10-03T04:29:17Z,sentiment,gpt-4.1-mini,1817,239,2056
2025-10-03T04:29:17Z,pre_sentiment,gpt-4.1-mini,293,1,294
2025-10-03T04:29:17Z,pre_sentiment,gpt-4.1-mini,281,1,282
2025-10-03T04:29:20Z,sentiment,gpt-4.1-mini,1032,176,1208
2025-10-03T04:29:20Z,pre_sentiment,gpt-4.1-mini,289,1,290
2025-10-03T04:29:23Z,sentiment,gpt-4.1-mini,1484,213,1697
2025-10-03T04:29:23Z,pre_sentiment,gpt-4.1-mini,281,1,282
2025-10-03T04:29:23Z,pre_sentiment,gpt-4.1-mini,281,1,282
2025-10-03T04:29:24Z,pre_sentiment,gpt-4.1-mini,281,1,282
2025-10-03T04:29:26Z,sentiment,gpt-4.1-mini,1169,148,1317
2025-10-03T04:29:26Z,pre_sentiment,gpt-4.1-mini,284,1,285
2025-10-03T04:29:29Z,sentiment,gpt-4.1-mini,1600,180,1780
2025-10-03T04:29:29Z,pre_sentiment,gpt-4.1-mini,296,1,297
2025-10-03T04:29:32Z,sentiment,gpt-4.1-mini,1283,211,1494
2025-10-03T04:29:32Z,pre_sentiment,gpt-4.1-mini,278,1,279
2025-10-03T04:29:32Z,pre_sentiment,gpt-4.1-mini,296,1,297
2025-10-03T04:29:33Z,pre_sentiment,gpt-4.1-mini,281,1,282
2025-10-03T04:29:33Z,pre_sentiment,gpt-4.1-mini,291,1,292
2025-10-03T04:29:33Z,pre_sentiment,gpt-4.1-mini,289,1,290
2025-10-03T04:29:37Z,sentiment,gpt-4.1-mini,1625,181,1806
2025-10-03T04:29:45Z,pre_sentiment,gpt-4.1-mini,307,1,308
2025-10-03T04:29:46Z,article_selection,gpt-4.1-mini,581,9,590
2025-10-03T04:29:47Z,article_selection,gpt-4.1-mini,1054,9,1063
2025-10-03T04:29:47Z,article_selection,gpt-4.1-mini,1165,9,1174
2025-10-03T04:29:48Z,article_selection,gpt-4.1-mini,1410,9,1419
2025-10-03T04:29:48Z,article_selection,gpt-4.1-mini,436,6,442
2025-10-03T04:30:03Z,final_summary_en,gpt-4.1-mini,1661,1187,2848
2025-10-03T04:30:21Z,final_summary_en,gpt-4.1-mini,1651,1162,2813
2025-10-03T04:30:35Z,final_summary_en,gpt-4.1-mini,1165,925,2090
2025-10-03T04:30:54Z,final_summary_en,gpt-4.1-mini,1986,1244,3230
2025-10-03T04:31:12Z,final_summary_en,gpt-4.1-mini,1283,1191,2474
2025-10-03T04:31:29Z,final_summary_en,gpt-4.1-mini,1353,1044,2397
2025-10-03T04:31:46Z,final_summary_en,gpt-4.1-mini,2695,1289,3984
2025-10-03T04:32:02Z,final_summary_en,gpt-4.1-mini,1465,1094,2559
2025-10-03T04:32:18Z,final_summary_en,gpt-4.1-mini,2844,926,3770
2025-10-03T04:32:36Z,final_summary_en,gpt-4.1-mini,1370,988,2358
2025-10-03T04:32:55Z,final_summary_en,gpt-4.1-mini,1652,1321,2973
2025-10-03T04:33:11Z,final_summary_en,gpt-4.1-mini,2270,1158,3428
2025-10-03T04:33:26Z,final_summary_en,gpt-4.1-mini,1212,1096,2308
2025-10-03T04:33:49Z,final_summary_en,gpt-4.1-mini,1633,1246,2879
2025-10-03T04:34:06Z,final_summary_en,gpt-4.1-mini,1360,1260,2620
2025-10-03T04:34:24Z,final_summary_en,gpt-4.1-mini,1583,1253,2836
2025-10-03T04:34:49Z,final_summary_en,gpt-4.1-mini,6922,1568,8490
2025-10-03T04:35:10Z,final_summary_en,gpt-4.1-mini,1048,1282,2330
2025-10-03T04:36:07Z,category_summary,gpt-4.1-mini,130,29,159
2025-10-03T04:36:09Z,category_summary,gpt-4.1-mini,124,46,170
2025-10-03T04:36:12Z,category_summary,gpt-4.1-mini,83,19,102
2025-10-03T04:36:14Z,category_summary,gpt-4.1-mini,142,32,174
2025-10-03T04:36:16Z,category_summary,gpt-4.1-mini,119,39,158
2025-10-03T04:36:17Z,category_summary,gpt-4.1-mini,116,24,140
2025-10-03T04:36:18Z,RUN_TOTAL,,148314,28972,177286
2025-10-04T04:23:57Z,pre_sentiment,gpt-4.1-mini,285,1,286
2025-10-04T04:23:58Z,pre_sentiment,gpt-4.1-mini,283,1,284
2025-10-04T04:23:58Z,pre_sentiment,gpt-4.1-mini,288,1,289
2025-10-04T04:23:59Z,pre_sentiment,gpt-4.1-mini,288,1,289
2025-10-04T04:24:00Z,pre_sentiment,gpt-4.1-mini,291,1,292
2025-10-04T04:24:01Z,pre_sentiment,gpt-4.1-mini,281,1,282
2025-10-04T04:24:01Z,pre_sentiment,gpt-4.1-mini,276,1,277
2025-10-04T04:24:01Z,pre_sentiment,gpt-4.1-mini,283,1,284
2025-10-04T04:24:01Z,pre_sentiment,gpt-4.1-mini,283,1,284
2025-10-04T04:24:02Z,pre_sentiment,gpt-4.1-mini,280,1,281
2025-10-04T04:24:06Z,sentiment,gpt-4.1-mini,1152,182,1334
2025-10-04T04:24:06Z,pre_sentiment,gpt-4.1-mini,277,1,278
2025-10-04T04:24:07Z,pre_sentiment,gpt-4.1-mini,280,1,281
2025-10-04T04:24:07Z,pre_sentiment,gpt-4.1-mini,278,1,279
2025-10-04T04:24:07Z,pre_sentiment,gpt-4.1-mini,279,1,280
2025-10-04T04:24:08Z,pre_sentiment,gpt-4.1-mini,290,1,291
2025-10-04T04:24:16Z,pre_sentiment,gpt-4.1-mini,281,1,282
2025-10-04T04:24:17Z,pre_sentiment,gpt-4.1-mini,275,1,276
2025-10-04T04:24:17Z,pre_sentiment,gpt-4.1-mini,279,1,280
2025-10-04T04:24:26Z,pre_sentiment,gpt-4.1-mini,276,1,277
2025-10-04T04:24:29Z,sentiment,gpt-4.1-mini,1631,244,1875
2025-10-04T04:24:30Z,pre_sentiment,gpt-4.1-mini,275,1,276
2025-10-04T04:24:33Z,pre_sentiment,gpt-4.1-mini,281,1,282
2025-10-04T04:24:37Z,sentiment,gpt-4.1-mini,1452,213,1665
2025-10-04T04:24:37Z,pre_sentiment,gpt-4.1-mini,280,1,281
2025-10-04T04:24:40Z,sentiment,gpt-4.1-mini,1901,200,2101
2025-10-04T04:24:41Z,pre_sentiment,gpt-4.1-mini,279,1,280
2025-10-04T04:24:43Z,sentiment,gpt-4.1-mini,1439,171,1610
2025-10-04T04:24:44Z,pre_sentiment,gpt-4.1-mini,285,1,286
2025-10-04T04:24:44Z,pre_sentiment,gpt-4.1-mini,280,1,281
2025-10-04T04:24:48Z,sentiment,gpt-4.1-mini,1502,197,1699
2025-10-04T04:24:48Z,pre_sentiment,gpt-4.1-mini,284,1,285
2025-10-04T04:24:51Z,sentiment,gpt-4.1-mini,1788,189,1977
2025-10-04T04:24:52Z,pre_sentiment,gpt-4.1-mini,276,1,277
2025-10-04T04:24:54Z,sentiment,gpt-4.1-mini,1391,185,1576
2025-10-04T04:24:54Z,pre_sentiment,gpt-4.1-mini,285,1,286
2025-10-04T04:24:58Z,sentiment,gpt-4.1-mini,2171,224,2395
2025-10-04T04:24:59Z,pre_sentiment,gpt-4.1-mini,284,1,285
2025-10-04T04:25:03Z,sentiment,gpt-4.1-mini,2420,237,2657
2025-10-04T04:25:03Z,pre_sentiment,gpt-4.1-mini,286,1,287
2025-10-04T04:25:04Z,pre_sentiment,gpt-4.1-mini,283,1,284
2025-10-04T04:25:07Z,sentiment,gpt-4.1-mini,2099,214,2313
2025-10-04T04:25:25Z,pre_sentiment,gpt-4.1-mini,298,1,299
2025-10-04T04:25:27Z,sentiment,gpt-4.1-mini,1008,91,1099
2025-10-04T04:25:27Z,pre_sentiment,gpt-4.1-mini,298,1,299
2025-10-04T04:25:30Z,sentiment,gpt-4.1-mini,1249,184,1433
2025-10-04T04:25:30Z,pre_sentiment,gpt-4.1-mini,299,1,300
2025-10-04T04:25:32Z,sentiment,gpt-4.1-mini,912,86,998
2025-10-04T04:25:34Z,pre_sentiment,gpt-4.1-mini,291,1,292
2025-10-04T04:25:37Z,sentiment,gpt-4.1-mini,1241,164,1405
2025-10-04T04:25:37Z,pre_sentiment,gpt-4.1-mini,298,1,299
2025-10-04T04:25:41Z,sentiment,gpt-4.1-mini,1934,187,2121
2025-10-04T04:25:41Z,pre_sentiment,gpt-4.1-mini,295,1,296
2025-10-04T04:25:44Z,sentiment,gpt-4.1-mini,1413,186,1599
2025-10-04T04:25:44Z,pre_sentiment,gpt-4.1-mini,296,1,297
2025-10-04T04:25:48Z,sentiment,gpt-4.1-mini,1380,203,1583
2025-10-04T04:25:48Z,pre_sentiment,gpt-4.1-mini,300,1,301
2025-10-04T04:25:49Z,pre_sentiment,gpt-4.1-mini,301,1,302
2025-10-04T04:25:51Z,sentiment,gpt-4.1-mini,1487,166,1653
2025-10-04T04:25:52Z,pre_sentiment,gpt-4.1-mini,292,1,293
2025-10-04T04:25:55Z,sentiment,gpt-4.1-mini,1614,136,1750
2025-10-04T04:25:55Z,pre_sentiment,gpt-4.1-mini,311,1,312
2025-10-04T04:25:56Z,sentiment,gpt-4.1-mini,933,81,1014
2025-10-04T04:25:57Z,pre_sentiment,gpt-4.1-mini,300,1,301
2025-10-04T04:25:58Z,sentiment,gpt-4.1-mini,1017,83,1100
2025-10-04T04:25:58Z,pre_sentiment,gpt-4.1-mini,303,1,304
2025-10-04T04:26:01Z,sentiment,gpt-4.1-mini,1478,171,1649
2025-10-04T04:26:28Z,pre_sentiment,gpt-4.1-mini,275,1,276
2025-10-04T04:26:30Z,sentiment,gpt-4.1-mini,900,113,1013
2025-10-04T04:26:42Z,pre_sentiment,gpt-4.1-mini,282,1,283
2025-10-04T04:26:42Z,pre_sentiment,gpt-4.1-mini,291,1,292
2025-10-04T04:26:46Z,sentiment,gpt-4.1-mini,2555,227,2782
2025-10-04T04:26:46Z,pre_sentiment,gpt-4.1-mini,264,1,265
2025-10-04T04:26:50Z,sentiment,gpt-4.1-mini,2008,199,2207
2025-10-04T04:26:55Z,pre_sentiment,gpt-4.1-mini,275,1,276
2025-10-04T04:27:08Z,pre_sentiment,gpt-4.1-mini,287,1,288
2025-10-04T04:27:10Z,sentiment,gpt-4.1-mini,1545,172,1717
2025-10-04T04:27:11Z,pre_sentiment,gpt-4.1-mini,287,1,288
2025-10-04T04:27:13Z,sentiment,gpt-4.1-mini,1589,169,1758
2025-10-04T04:27:13Z,pre_sentiment,gpt-4.1-mini,283,1,284
2025-10-04T04:27:16Z,sentiment,gpt-4.1-mini,1596,164,1760
2025-10-04T04:27:16Z,pre_sentiment,gpt-4.1-mini,281,1,282
2025-10-04T04:27:19Z,sentiment,gpt-4.1-mini,1872,161,2033
2025-10-04T04:27:19Z,pre_sentiment,gpt-4.1-mini,282,1,283
2025-10-04T04:27:24Z,sentiment,gpt-4.1-mini,1902,182,2084
2025-10-04T04:27:25Z,pre_sentiment,gpt-4.1-mini,291,1,292
2025-10-04T04:27:27Z,sentiment,gpt-4.1-mini,1738,180,1918
2025-10-04T04:27:28Z,pre_sentiment,gpt-4.1-mini,291,1,292
2025-10-04T04:27:30Z,sentiment,gpt-4.1-mini,2395,156,2551
2025-10-04T04:27:30Z,pre_sentiment,gpt-4.1-mini,288,1,289
2025-10-04T04:27:32Z,sentiment,gpt-4.1-mini,2446,143,2589
2025-10-04T04:27:41Z,pre_sentiment,gpt-4.1-mini,280,1,281
2025-10-04T04:27:48Z,pre_sentiment,gpt-4.1-mini,299,1,300
2025-10-04T04:27:50Z,sentiment,gpt-4.1-mini,1191,120,1311
2025-10-04T04:27:50Z,pre_sentiment,gpt-4.1-mini,283,1,284
2025-10-04T04:27:53Z,sentiment,gpt-4.1-mini,1150,126,1276
2025-10-04T04:27:53Z,pre_sentiment,gpt-4.1-mini,294,1,295
2025-10-04T04:27:55Z,sentiment,gpt-4.1-mini,1907,131,2038
2025-10-04T04:28:00Z,pre_sentiment,gpt-4.1-mini,280,1,281
2025-10-04T04:28:19Z,pre_sentiment,gpt-4.1-mini,302,1,303
2025-10-04T04:28:21Z,sentiment,gpt-4.1-mini,1983,153,2136
2025-10-04T04:28:22Z,pre_sentiment,gpt-4.1-mini,287,1,288
2025-10-04T04:28:25Z,sentiment,gpt-4.1-mini,1414,173,1587
2025-10-04T04:28:35Z,pre_sentiment,gpt-4.1-mini,290,1,291
2025-10-04T04:28:38Z,sentiment,gpt-4.1-mini,1720,203,1923
2025-10-04T04:28:45Z,pre_sentiment,gpt-4.1-mini,282,1,283
2025-10-04T04:28:48Z,sentiment,gpt-4.1-mini,1908,233,2141
2025-10-04T04:28:49Z,pre_sentiment,gpt-4.1-mini,287,1,288
2025-10-04T04:28:51Z,sentiment,gpt-4.1-mini,1657,172,1829
2025-10-04T04:28:52Z,pre_sentiment,gpt-4.1-mini,287,1,288
2025-10-04T04:28:54Z,sentiment,gpt-4.1-mini,1364,192,1556
2025-10-04T04:28:55Z,pre_sentiment,gpt-4.1-mini,291,1,292
2025-10-04T04:28:58Z,sentiment,gpt-4.1-mini,1821,211,2032
2025-10-04T04:28:58Z,pre_sentiment,gpt-4.1-mini,293,1,294
2025-10-04T04:28:58Z,pre_sentiment,gpt-4.1-mini,287,1,288
2025-10-04T04:28:58Z,pre_sentiment,gpt-4.1-mini,285,1,286
2025-10-04T04:29:01Z,sentiment,gpt-4.1-mini,1536,196,1732
2025-10-04T04:29:01Z,pre_sentiment,gpt-4.1-mini,288,1,289
2025-10-04T04:29:02Z,pre_sentiment,gpt-4.1-mini,284,1,285
2025-10-04T04:29:16Z,pre_sentiment,gpt-4.1-mini,279,1,280
2025-10-04T04:29:16Z,pre_sentiment,gpt-4.1-mini,286,1,287
2025-10-04T04:29:19Z,sentiment,gpt-4.1-mini,1356,190,1546
2025-10-04T04:29:33Z,pre_sentiment,gpt-4.1-mini,292,1,293
2025-10-04T04:29:33Z,pre_sentiment,gpt-4.1-mini,286,1,287
2025-10-04T04:29:33Z,pre_sentiment,gpt-4.1-mini,290,1,291
2025-10-04T04:29:36Z,sentiment,gpt-4.1-mini,1886,200,2086
2025-10-04T04:29:37Z,pre_sentiment,gpt-4.1-mini,282,1,283
2025-10-04T04:29:39Z,sentiment,gpt-4.1-mini,1131,182,1313
2025-10-04T04:29:40Z,pre_sentiment,gpt-4.1-mini,293,1,294
2025-10-04T04:29:42Z,sentiment,gpt-4.1-mini,1343,151,1494
2025-10-04T04:29:43Z,pre_sentiment,gpt-4.1-mini,288,1,289
2025-10-04T04:29:43Z,pre_sentiment,gpt-4.1-mini,281,1,282
2025-10-04T04:29:43Z,pre_sentiment,gpt-4.1-mini,283,1,284
2025-10-04T04:29:44Z,pre_sentiment,gpt-4.1-mini,278,1,279
2025-10-04T04:29:44Z,pre_sentiment,gpt-4.1-mini,282,1,283
2025-10-04T04:29:47Z,sentiment,gpt-4.1-mini,1135,222,1357
2025-10-04T04:29:47Z,pre_sentiment,gpt-4.1-mini,285,1,286
2025-10-04T04:29:49Z,sentiment,gpt-4.1-mini,1149,150,1299
2025-10-04T04:29:50Z,pre_sentiment,gpt-4.1-mini,293,1,294
2025-10-04T04:29:52Z,sentiment,gpt-4.1-mini,1206,180,1386
2025-10-04T04:29:53Z,pre_sentiment,gpt-4.1-mini,281,1,282
2025-10-04T04:29:55Z,sentiment,gpt-4.1-mini,1264,142,1406
2025-10-04T04:29:55Z,pre_sentiment,gpt-4.1-mini,278,1,279
2025-10-04T04:29:59Z,sentiment,gpt-4.1-mini,3298,245,3543
2025-10-04T04:29:59Z,pre_sentiment,gpt-4.1-mini,284,1,285
2025-10-04T04:30:01Z,sentiment,gpt-4.1-mini,1103,120,1223
2025-10-04T04:30:21Z,article_selection,gpt-4.1-mini,1416,9,1425
2025-10-04T04:30:21Z,article_selection,gpt-4.1-mini,967,9,976
2025-10-04T04:30:22Z,article_selection,gpt-4.1-mini,1086,16,1102
2025-10-04T04:30:23Z,article_selection,gpt-4.1-mini,960,9,969
2025-10-04T04:30:23Z,article_selection,gpt-4.1-mini,952,12,964
2025-10-04T04:30:43Z,final_summary_en,gpt-4.1-mini,1399,1159,2558
2025-10-04T04:31:01Z,final_summary_en,gpt-4.1-mini,1248,1082,2330
2025-10-04T04:31:21Z,final_summary_en,gpt-4.1-mini,998,983,1981
2025-10-04T04:31:41Z,final_summary_en,gpt-4.1-mini,1131,1144,2275
2025-10-04T04:32:03Z,final_summary_en,gpt-4.1-mini,1669,1254,2923
2025-10-04T04:32:24Z,final_summary_en,gpt-4.1-mini,1748,1084,2832
2025-10-04T04:32:42Z,final_summary_en,gpt-4.1-mini,1483,1225,2708
2025-10-04T04:32:58Z,final_summary_en,gpt-4.1-mini,1116,1087,2203
2025-10-04T04:33:14Z,final_summary_en,gpt-4.1-mini,903,1054,1957
2025-10-04T04:33:36Z,final_summary_en,gpt-4.1-mini,2328,1249,3577
2025-10-04T04:33:53Z,final_summary_en,gpt-4.1-mini,903,1131,2034
2025-10-04T04:34:11Z,final_summary_en,gpt-4.1-mini,1216,1090,2306
2025-10-04T04:34:28Z,final_summary_en,gpt-4.1-mini,1194,1121,2315
2025-10-04T04:34:40Z,final_summary_en,gpt-4.1-mini,1639,956,2595
2025-10-04T04:34:59Z,final_summary_en,gpt-4.1-mini,1393,1299,2692
2025-10-04T04:35:14Z,final_summary_en,gpt-4.1-mini,1859,982,2841
2025-10-04T04:35:31Z,final_summary_en,gpt-4.1-mini,1934,1091,3025
2025-10-04T04:35:49Z,final_summary_en,gpt-4.1-mini,1645,1254,2899
2025-10-04T04:36:09Z,final_summary_en,gpt-4.1-mini,1682,1068,2750
2025-10-04T04:36:33Z,final_summary_en,gpt-4.1-mini,890,1236,2126
2025-10-04T04:37:33Z,category_summary,gpt-4.1-mini,117,24,141
2025-10-04T04:37:35Z,category_summary,gpt-4.1-mini,136,27,163
2025-10-04T04:37:37Z,category_summary,gpt-4.1-mini,138,37,175
2025-10-04T04:37:40Z,category_summary,gpt-4.1-mini,139,38,177
2025-10-04T04:37:42Z,category_summary,gpt-4.1-mini,127,25,152
2025-10-04T04:37:43Z,RUN_TOTAL,,148126,32398,180524
2025-10-05T04:23:49Z,pre_sentiment,gpt-4.1-mini,288,1,289
2025-10-05T04:23:49Z,pre_sentiment,gpt-4.1-mini,285,1,286
2025-10-05T04:23:50Z,pre_sentiment,gpt-4.1-mini,279,1,280
2025-10-05T04:23:53Z,pre_sentiment,gpt-4.1-mini,281,1,282
2025-10-05T04:23:53Z,pre_sentiment,gpt-4.1-mini,280,1,281
2025-10-05T04:23:54Z,pre_sentiment,gpt-4.1-mini,281,1,282
2025-10-05T04:23:54Z,pre_sentiment,gpt-4.1-mini,284,1,285
2025-10-05T04:23:58Z,sentiment,gpt-4.1-mini,1475,228,1703
2025-10-05T04:23:59Z,pre_sentiment,gpt-4.1-mini,274,1,275
2025-10-05T04:24:00Z,pre_sentiment,gpt-4.1-mini,278,1,279
2025-10-05T04:24:01Z,pre_sentiment,gpt-4.1-mini,282,1,283
2025-10-05T04:24:01Z,pre_sentiment,gpt-4.1-mini,279,1,280
2025-10-05T04:24:02Z,pre_sentiment,gpt-4.1-mini,288,1,289
2025-10-05T04:24:02Z,pre_sentiment,gpt-4.1-mini,295,1,296
2025-10-05T04:24:04Z,sentiment,gpt-4.1-mini,2281,149,2430
2025-10-05T04:24:04Z,pre_sentiment,gpt-4.1-mini,285,1,286
2025-10-05T04:24:21Z,pre_sentiment,gpt-4.1-mini,279,1,280
2025-10-05T04:24:21Z,pre_sentiment,gpt-4.1-mini,284,1,285
2025-10-05T04:24:25Z,sentiment,gpt-4.1-mini,1475,206,1681
2025-10-05T04:24:29Z,pre_sentiment,gpt-4.1-mini,278,1,279
2025-10-05T04:24:30Z,pre_sentiment,gpt-4.1-mini,285,1,286
2025-10-05T04:24:33Z,sentiment,gpt-4.1-mini,1923,245,2168
2025-10-05T04:24:33Z,pre_sentiment,gpt-4.1-mini,276,1,277
2025-10-05T04:24:36Z,sentiment,gpt-4.1-mini,1460,197,1657
2025-10-05T04:24:36Z,pre_sentiment,gpt-4.1-mini,284,1,285
2025-10-05T04:24:40Z,sentiment,gpt-4.1-mini,1926,200,2126
2025-10-05T04:24:40Z,pre_sentiment,gpt-4.1-mini,283,1,284
2025-10-05T04:24:42Z,sentiment,gpt-4.1-mini,1416,168,1584
2025-10-05T04:24:42Z,pre_sentiment,gpt-4.1-mini,283,1,284
2025-10-05T04:24:45Z,sentiment,gpt-4.1-mini,1625,226,1851
2025-10-05T04:24:46Z,pre_sentiment,gpt-4.1-mini,281,1,282
2025-10-05T04:24:48Z,sentiment,gpt-4.1-mini,1601,213,1814
2025-10-05T04:25:03Z,pre_sentiment,gpt-4.1-mini,298,1,299
2025-10-05T04:25:03Z,pre_sentiment,gpt-4.1-mini,299,1,300
2025-10-05T04:25:04Z,sentiment,gpt-4.1-mini,912,88,1000
2025-10-05T04:25:04Z,pre_sentiment,gpt-4.1-mini,291,1,292
2025-10-05T04:25:07Z,sentiment,gpt-4.1-mini,1241,183,1424
2025-10-05T04:25:07Z,pre_sentiment,gpt-4.1-mini,295,1,296
2025-10-05T04:25:10Z,sentiment,gpt-4.1-mini,1413,200,1613
2025-10-05T04:25:10Z,pre_sentiment,gpt-4.1-mini,296,1,297
2025-10-05T04:25:13Z,sentiment,gpt-4.1-mini,1380,224,1604
2025-10-05T04:25:13Z,pre_sentiment,gpt-4.1-mini,300,1,301
2025-10-05T04:25:13Z,pre_sentiment,gpt-4.1-mini,301,1,302
2025-10-05T04:25:15Z,sentiment,gpt-4.1-mini,1487,136,1623
2025-10-05T04:25:16Z,pre_sentiment,gpt-4.1-mini,292,1,293
2025-10-05T04:25:19Z,sentiment,gpt-4.1-mini,1614,106,1720
2025-10-05T04:25:19Z,pre_sentiment,gpt-4.1-mini,311,1,312
2025-10-05T04:25:21Z,sentiment,gpt-4.1-mini,933,90,1023
2025-10-05T04:25:21Z,pre_sentiment,gpt-4.1-mini,300,1,301
2025-10-05T04:25:22Z,sentiment,gpt-4.1-mini,1017,83,1100
2025-10-05T04:26:07Z,pre_sentiment,gpt-4.1-mini,270,1,271
2025-10-05T04:26:58Z,pre_sentiment,gpt-4.1-mini,281,1,282
2025-10-05T04:27:01Z,sentiment,gpt-4.1-mini,2080,196,2276
2025-10-05T04:27:12Z,pre_sentiment,gpt-4.1-mini,277,1,278
2025-10-05T04:27:23Z,pre_sentiment,gpt-4.1-mini,262,1,263
2025-10-05T04:27:24Z,sentiment,gpt-4.1-mini,813,76,889
2025-10-05T04:27:37Z,article_selection,gpt-4.1-mini,931,12,943
2025-10-05T04:27:37Z,article_selection,gpt-4.1-mini,422,5,427
2025-10-05T04:27:38Z,article_selection,gpt-4.1-mini,414,6,420
2025-10-05T04:27:57Z,final_summary_en,gpt-4.1-mini,1364,1290,2654
2025-10-05T04:28:15Z,final_summary_en,gpt-4.1-mini,1698,1094,2792
2025-10-05T04:28:27Z,final_summary_en,gpt-4.1-mini,1178,963,2141
2025-10-05T04:28:45Z,final_summary_en,gpt-4.1-mini,1156,1138,2294
2025-10-05T04:29:01Z,final_summary_en,gpt-4.1-mini,1246,1183,2429
2025-10-05T04:29:14Z,final_summary_en,gpt-4.1-mini,1145,1049,2194
2025-10-05T04:29:28Z,final_summary_en,gpt-4.1-mini,1214,1021,2235
2025-10-05T04:29:43Z,final_summary_en,gpt-4.1-mini,1674,1056,2730
2025-10-05T04:29:57Z,final_summary_en,gpt-4.1-mini,1834,1149,2983
2025-10-05T04:30:25Z,category_summary,gpt-4.1-mini,126,28,154
2025-10-05T04:30:27Z,category_summary,gpt-4.1-mini,98,22,120
2025-10-05T04:30:29Z,category_summary,gpt-4.1-mini,93,25,118
2025-10-05T04:30:31Z,category_summary,gpt-4.1-mini,86,19,105
2025-10-05T04:30:32Z,RUN_TOTAL,,53316,13311,66627
2025-10-06T04:24:42Z,pre_sentiment,gpt-4.1-mini,288,1,289
2025-10-06T04:24:43Z,pre_sentiment,gpt-4.1-mini,286,1,287
2025-10-06T04:24:46Z,sentiment,gpt-4.1-mini,1946,166,2112
2025-10-06T04:24:46Z,pre_sentiment,gpt-4.1-mini,292,1,293
2025-10-06T04:24:47Z,pre_sentiment,gpt-4.1-mini,293,1,294
2025-10-06T04:24:47Z,pre_sentiment,gpt-4.1-mini,280,1,281
2025-10-06T04:24:48Z,pre_sentiment,gpt-4.1-mini,286,1,287
2025-10-06T04:24:49Z,pre_sentiment,gpt-4.1-mini,283,1,284
2025-10-06T04:24:49Z,pre_sentiment,gpt-4.1-mini,280,1,281
2025-10-06T04:24:51Z,sentiment,gpt-4.1-mini,2448,162,2610
2025-10-06T04:24:52Z,pre_sentiment,gpt-4.1-mini,286,1,287
2025-10-06T04:24:52Z,pre_sentiment,gpt-4.1-mini,282,1,283
2025-10-06T04:24:53Z,pre_sentiment,gpt-4.1-mini,286,1,287
2025-10-06T04:24:54Z,pre_sentiment,gpt-4.1-mini,286,1,287
2025-10-06T04:24:56Z,sentiment,gpt-4.1-mini,1929,180,2109
2025-10-06T04:24:57Z,pre_sentiment,gpt-4.1-mini,289,1,290
2025-10-06T04:24:57Z,pre_sentiment,gpt-4.1-mini,285,1,286
2025-10-06T04:24:59Z,sentiment,gpt-4.1-mini,1739,108,1847
2025-10-06T04:25:03Z,pre_sentiment,gpt-4.1-mini,282,1,283
2025-10-06T04:25:04Z,pre_sentiment,gpt-4.1-mini,293,1,294
2025-10-06T04:25:04Z,pre_sentiment,gpt-4.1-mini,280,1,281
2025-10-06T04:25:08Z,sentiment,gpt-4.1-mini,1958,193,2151
2025-10-06T04:25:15Z,pre_sentiment,gpt-4.1-mini,279,1,280
2025-10-06T04:25:24Z,pre_sentiment,gpt-4.1-mini,278,1,279
2025-10-06T04:25:25Z,pre_sentiment,gpt-4.1-mini,279,1,280
2025-10-06T04:25:29Z,sentiment,gpt-4.1-mini,1492,217,1709
2025-10-06T04:25:30Z,pre_sentiment,gpt-4.1-mini,279,1,280
2025-10-06T04:25:33Z,sentiment,gpt-4.1-mini,1716,222,1938
2025-10-06T04:25:33Z,pre_sentiment,gpt-4.1-mini,296,1,297
2025-10-06T04:25:37Z,sentiment,gpt-4.1-mini,1415,239,1654
2025-10-06T04:25:38Z,pre_sentiment,gpt-4.1-mini,285,1,286
2025-10-06T04:25:38Z,pre_sentiment,gpt-4.1-mini,285,1,286
2025-10-06T04:25:41Z,sentiment,gpt-4.1-mini,1685,213,1898
2025-10-06T04:25:42Z,pre_sentiment,gpt-4.1-mini,281,1,282
2025-10-06T04:25:45Z,sentiment,gpt-4.1-mini,1612,183,1795
2025-10-06T04:25:45Z,pre_sentiment,gpt-4.1-mini,284,1,285
2025-10-06T04:25:49Z,sentiment,gpt-4.1-mini,1657,189,1846
2025-10-06T04:26:03Z,pre_sentiment,gpt-4.1-mini,298,1,299
2025-10-06T04:26:04Z,pre_sentiment,gpt-4.1-mini,299,1,300
2025-10-06T04:26:05Z,sentiment,gpt-4.1-mini,912,86,998
2025-10-06T04:26:06Z,pre_sentiment,gpt-4.1-mini,291,1,292
2025-10-06T04:26:09Z,sentiment,gpt-4.1-mini,1241,175,1416
2025-10-06T04:26:09Z,pre_sentiment,gpt-4.1-mini,300,1,301
2025-10-06T04:26:09Z,pre_sentiment,gpt-4.1-mini,301,1,302
2025-10-06T04:26:12Z,sentiment,gpt-4.1-mini,1487,129,1616
2025-10-06T04:26:12Z,pre_sentiment,gpt-4.1-mini,292,1,293
2025-10-06T04:26:15Z,sentiment,gpt-4.1-mini,1614,133,1747
2025-10-06T04:26:15Z,pre_sentiment,gpt-4.1-mini,311,1,312
2025-10-06T04:26:17Z,sentiment,gpt-4.1-mini,933,82,1015
2025-10-06T04:26:17Z,pre_sentiment,gpt-4.1-mini,300,1,301
2025-10-06T04:26:19Z,sentiment,gpt-4.1-mini,1017,83,1100
2025-10-06T04:26:46Z,pre_sentiment,gpt-4.1-mini,269,1,270
2025-10-06T04:26:50Z,pre_sentiment,gpt-4.1-mini,279,1,280
2025-10-06T04:27:05Z,pre_sentiment,gpt-4.1-mini,287,1,288
2025-10-06T04:27:26Z,pre_sentiment,gpt-4.1-mini,285,1,286
2025-10-06T04:27:31Z,sentiment,gpt-4.1-mini,1517,237,1754
2025-10-06T04:27:32Z,pre_sentiment,gpt-4.1-mini,289,1,290
2025-10-06T04:27:36Z,sentiment,gpt-4.1-mini,2050,161,2211
2025-10-06T04:27:51Z,pre_sentiment,gpt-4.1-mini,279,1,280
2025-10-06T04:27:55Z,sentiment,gpt-4.1-mini,1827,270,2097
2025-10-06T04:28:07Z,pre_sentiment,gpt-4.1-mini,290,1,291
2025-10-06T04:28:19Z,pre_sentiment,gpt-4.1-mini,294,1,295
2025-10-06T04:28:43Z,article_selection,gpt-4.1-mini,990,12,1002
2025-10-06T04:28:43Z,article_selection,gpt-4.1-mini,421,10,431
2025-10-06T04:29:04Z,final_summary_en,gpt-4.1-mini,1241,1048,2289
2025-10-06T04:29:22Z,final_summary_en,gpt-4.1-mini,1188,1124,2312
2025-10-06T04:29:37Z,final_summary_en,gpt-4.1-mini,1407,928,2335
2025-10-06T04:29:59Z,final_summary_en,gpt-4.1-mini,1622,1107,2729
2025-10-06T04:30:20Z,final_summary_en,gpt-4.1-mini,1290,1032,2322
2025-10-06T04:30:41Z,final_summary_en,gpt-4.1-mini,1443,900,2343
2025-10-06T04:31:05Z,final_summary_en,gpt-4.1-mini,1707,1251,2958
2025-10-06T04:31:29Z,category_summary,gpt-4.1-mini,127,49,176
2025-10-06T04:31:31Z,category_summary,gpt-4.1-mini,86,18,104
2025-10-06T04:31:32Z,category_summary,gpt-4.1-mini,100,22,122
2025-10-06T04:31:34Z,RUN_TOTAL,,55884,10971,66855
2025-10-07T04:25:30Z,pre_sentiment,gpt-4.1-mini,288,1,289
2025-10-07T04:25:31Z,pre_sentiment,gpt-4.1-mini,289,1,290
2025-10-07T04:25:32Z,pre_sentiment,gpt-4.1-mini,292,1,293
2025-10-07T04:25:32Z,pre_sentiment,gpt-4.1-mini,278,1,279
2025-10-07T04:25:33Z,pre_sentiment,gpt-4.1-mini,289,1,290
2025-10-07T04:25:34Z,pre_sentiment,gpt-4.1-mini,282,1,283
2025-10-07T04:25:34Z,pre_sentiment,gpt-4.1-mini,279,1,280
2025-10-07T04:25:35Z,pre_sentiment,gpt-4.1-mini,293,1,294
2025-10-07T04:25:36Z,pre_sentiment,gpt-4.1-mini,277,1,278
2025-10-07T04:25:36Z,pre_sentiment,gpt-4.1-mini,281,1,282
2025-10-07T04:25:37Z,pre_sentiment,gpt-4.1-mini,281,1,282
2025-10-07T04:25:42Z,sentiment,gpt-4.1-mini,1832,240,2072
2025-10-07T04:25:42Z,pre_sentiment,gpt-4.1-mini,284,1,285
2025-10-07T04:25:43Z,pre_sentiment,gpt-4.1-mini,283,1,284
2025-10-07T04:25:43Z,pre_sentiment,gpt-4.1-mini,293,1,294
2025-10-07T04:25:44Z,pre_sentiment,gpt-4.1-mini,284,1,285
2025-10-07T04:25:46Z,sentiment,gpt-4.1-mini,996,146,1142
2025-10-07T04:25:53Z,pre_sentiment,gpt-4.1-mini,284,1,285
2025-10-07T04:25:54Z,pre_sentiment,gpt-4.1-mini,280,1,281
2025-10-07T04:25:57Z,sentiment,gpt-4.1-mini,1284,207,1491
2025-10-07T04:25:57Z,pre_sentiment,gpt-4.1-mini,282,1,283
2025-10-07T04:25:58Z,pre_sentiment,gpt-4.1-mini,291,1,292
2025-10-07T04:26:08Z,pre_sentiment,gpt-4.1-mini,279,1,280
2025-10-07T04:26:11Z,sentiment,gpt-4.1-mini,1606,182,1788
2025-10-07T04:26:11Z,pre_sentiment,gpt-4.1-mini,286,1,287
2025-10-07T04:26:14Z,sentiment,gpt-4.1-mini,1756,224,1980
2025-10-07T04:26:15Z,pre_sentiment,gpt-4.1-mini,277,1,278
2025-10-07T04:26:18Z,sentiment,gpt-4.1-mini,1497,192,1689
2025-10-07T04:26:18Z,pre_sentiment,gpt-4.1-mini,286,1,287
2025-10-07T04:26:22Z,sentiment,gpt-4.1-mini,1802,206,2008
2025-10-07T04:26:22Z,pre_sentiment,gpt-4.1-mini,289,1,290
2025-10-07T04:26:25Z,sentiment,gpt-4.1-mini,2125,187,2312
2025-10-07T04:26:25Z,pre_sentiment,gpt-4.1-mini,285,1,286
2025-10-07T04:26:29Z,sentiment,gpt-4.1-mini,1917,215,2132
2025-10-07T04:26:29Z,pre_sentiment,gpt-4.1-mini,288,1,289
2025-10-07T04:26:31Z,sentiment,gpt-4.1-mini,1600,138,1738
2025-10-07T04:26:31Z,pre_sentiment,gpt-4.1-mini,282,1,283
2025-10-07T04:26:34Z,sentiment,gpt-4.1-mini,1665,144,1809
2025-10-07T04:26:34Z,pre_sentiment,gpt-4.1-mini,282,1,283
2025-10-07T04:26:38Z,sentiment,gpt-4.1-mini,2203,205,2408
2025-10-07T04:26:38Z,pre_sentiment,gpt-4.1-mini,284,1,285
2025-10-07T04:26:42Z,sentiment,gpt-4.1-mini,1821,200,2021
2025-10-07T04:26:43Z,pre_sentiment,gpt-4.1-mini,280,1,281
2025-10-07T04:26:45Z,sentiment,gpt-4.1-mini,1572,176,1748
2025-10-07T04:26:45Z,pre_sentiment,gpt-4.1-mini,285,1,286
2025-10-07T04:27:03Z,pre_sentiment,gpt-4.1-mini,298,1,299
2025-10-07T04:27:07Z,sentiment,gpt-4.1-mini,1095,192,1287
2025-10-07T04:27:07Z,pre_sentiment,gpt-4.1-mini,301,1,302
2025-10-07T04:27:12Z,sentiment,gpt-4.1-mini,2099,216,2315
2025-10-07T04:27:12Z,pre_sentiment,gpt-4.1-mini,299,1,300
2025-10-07T04:27:15Z,sentiment,gpt-4.1-mini,1584,188,1772
2025-10-07T04:27:16Z,pre_sentiment,gpt-4.1-mini,294,1,295
2025-10-07T04:27:20Z,sentiment,gpt-4.1-mini,1867,235,2102
2025-10-07T04:27:21Z,pre_sentiment,gpt-4.1-mini,299,1,300
2025-10-07T04:27:24Z,sentiment,gpt-4.1-mini,2403,208,2611
2025-10-07T04:27:24Z,pre_sentiment,gpt-4.1-mini,303,1,304
2025-10-07T04:27:26Z,sentiment,gpt-4.1-mini,1561,170,1731
2025-10-07T04:27:27Z,pre_sentiment,gpt-4.1-mini,303,1,304
2025-10-07T04:27:29Z,sentiment,gpt-4.1-mini,1841,179,2020
2025-10-07T04:27:30Z,pre_sentiment,gpt-4.1-mini,300,1,301
2025-10-07T04:27:32Z,sentiment,gpt-4.1-mini,1739,189,1928
2025-10-07T04:27:33Z,pre_sentiment,gpt-4.1-mini,300,1,301
2025-10-07T04:27:35Z,sentiment,gpt-4.1-mini,1634,144,1778
2025-10-07T04:27:35Z,pre_sentiment,gpt-4.1-mini,298,1,299
2025-10-07T04:27:36Z,pre_sentiment,gpt-4.1-mini,299,1,300
2025-10-07T04:27:37Z,sentiment,gpt-4.1-mini,912,96,1008
2025-10-07T04:27:38Z,pre_sentiment,gpt-4.1-mini,291,1,292
2025-10-07T04:27:41Z,sentiment,gpt-4.1-mini,1241,173,1414
2025-10-07T04:28:03Z,pre_sentiment,gpt-4.1-mini,291,1,292
2025-10-07T04:28:06Z,sentiment,gpt-4.1-mini,2392,191,2583
2025-10-07T04:28:06Z,pre_sentiment,gpt-4.1-mini,289,1,290
2025-10-07T04:28:11Z,sentiment,gpt-4.1-mini,1334,204,1538
2025-10-07T04:28:22Z,pre_sentiment,gpt-4.1-mini,290,1,291
2025-10-07T04:28:23Z,pre_sentiment,gpt-4.1-mini,290,1,291
2025-10-07T04:28:32Z,pre_sentiment,gpt-4.1-mini,279,1,280
2025-10-07T04:28:32Z,pre_sentiment,gpt-4.1-mini,272,1,273
2025-10-07T04:28:36Z,sentiment,gpt-4.1-mini,2646,252,2898
2025-10-07T04:28:37Z,pre_sentiment,gpt-4.1-mini,277,1,278
2025-10-07T04:28:37Z,pre_sentiment,gpt-4.1-mini,278,1,279
2025-10-07T04:28:38Z,pre_sentiment,gpt-4.1-mini,279,1,280
2025-10-07T04:28:51Z,pre_sentiment,gpt-4.1-mini,286,1,287
2025-10-07T04:28:54Z,sentiment,gpt-4.1-mini,1550,181,1731
2025-10-07T04:28:54Z,pre_sentiment,gpt-4.1-mini,285,1,286
2025-10-07T04:28:57Z,sentiment,gpt-4.1-mini,1547,214,1761
2025-10-07T04:28:57Z,pre_sentiment,gpt-4.1-mini,285,1,286
2025-10-07T04:29:00Z,sentiment,gpt-4.1-mini,4658,206,4864
2025-10-07T04:29:01Z,pre_sentiment,gpt-4.1-mini,290,1,291
2025-10-07T04:29:03Z,sentiment,gpt-4.1-mini,1604,186,1790
2025-10-07T04:29:03Z,pre_sentiment,gpt-4.1-mini,287,1,288
2025-10-07T04:29:04Z,pre_sentiment,gpt-4.1-mini,279,1,280
2025-10-07T04:29:07Z,sentiment,gpt-4.1-mini,1887,199,2086
2025-10-07T04:29:34Z,pre_sentiment,gpt-4.1-mini,289,1,290
2025-10-07T04:29:37Z,sentiment,gpt-4.1-mini,1427,211,1638
2025-10-07T04:29:38Z,pre_sentiment,gpt-4.1-mini,290,1,291
2025-10-07T04:29:40Z,sentiment,gpt-4.1-mini,1122,113,1235
2025-10-07T04:30:07Z,pre_sentiment,gpt-4.1-mini,298,1,299
2025-10-07T04:30:10Z,sentiment,gpt-4.1-mini,1705,171,1876
2025-10-07T04:30:10Z,pre_sentiment,gpt-4.1-mini,289,1,290
2025-10-07T04:30:13Z,sentiment,gpt-4.1-mini,1821,220,2041
2025-10-07T04:30:14Z,pre_sentiment,gpt-4.1-mini,289,1,290
2025-10-07T04:30:16Z,sentiment,gpt-4.1-mini,2050,150,2200
2025-10-07T04:30:26Z,pre_sentiment,gpt-4.1-mini,291,1,292
2025-10-07T04:30:30Z,sentiment,gpt-4.1-mini,1388,195,1583
2025-10-07T04:30:31Z,pre_sentiment,gpt-4.1-mini,292,1,293
2025-10-07T04:30:33Z,sentiment,gpt-4.1-mini,1300,119,1419
2025-10-07T04:30:34Z,pre_sentiment,gpt-4.1-mini,293,1,294
2025-10-07T04:30:36Z,sentiment,gpt-4.1-mini,1499,172,1671
2025-10-07T04:30:37Z,pre_sentiment,gpt-4.1-mini,272,1,273
2025-10-07T04:30:39Z,sentiment,gpt-4.1-mini,1381,112,1493
2025-10-07T04:30:39Z,pre_sentiment,gpt-4.1-mini,286,1,287
2025-10-07T04:30:41Z,sentiment,gpt-4.1-mini,1249,125,1374
2025-10-07T04:30:48Z,pre_sentiment,gpt-4.1-mini,285,1,286
2025-10-07T04:30:50Z,sentiment,gpt-4.1-mini,1516,189,1705
2025-10-07T04:30:51Z,pre_sentiment,gpt-4.1-mini,286,1,287
2025-10-07T04:30:51Z,pre_sentiment,gpt-4.1-mini,291,1,292
2025-10-07T04:30:52Z,pre_sentiment,gpt-4.1-mini,292,1,293
2025-10-07T04:30:55Z,sentiment,gpt-4.1-mini,1459,192,1651
2025-10-07T04:30:55Z,pre_sentiment,gpt-4.1-mini,289,1,290
2025-10-07T04:30:55Z,pre_sentiment,gpt-4.1-mini,286,1,287
2025-10-07T04:30:56Z,pre_sentiment,gpt-4.1-mini,287,1,288
2025-10-07T04:30:56Z,pre_sentiment,gpt-4.1-mini,298,1,299
2025-10-07T04:31:11Z,pre_sentiment,gpt-4.1-mini,285,1,286
2025-10-07T04:31:13Z,sentiment,gpt-4.1-mini,2882,178,3060
2025-10-07T04:31:13Z,pre_sentiment,gpt-4.1-mini,285,1,286
2025-10-07T04:31:16Z,sentiment,gpt-4.1-mini,2105,209,2314
2025-10-07T04:31:17Z,pre_sentiment,gpt-4.1-mini,291,1,292
2025-10-07T04:31:30Z,pre_sentiment,gpt-4.1-mini,289,1,290
2025-10-07T04:31:31Z,pre_sentiment,gpt-4.1-mini,289,1,290
2025-10-07T04:31:31Z,pre_sentiment,gpt-4.1-mini,292,1,293
2025-10-07T04:31:34Z,sentiment,gpt-4.1-mini,1088,170,1258
2025-10-07T04:31:34Z,pre_sentiment,gpt-4.1-mini,286,1,287
2025-10-07T04:31:35Z,pre_sentiment,gpt-4.1-mini,279,1,280
2025-10-07T04:31:38Z,sentiment,gpt-4.1-mini,1531,230,1761
2025-10-07T04:31:39Z,pre_sentiment,gpt-4.1-mini,282,1,283
2025-10-07T04:31:39Z,pre_sentiment,gpt-4.1-mini,273,1,274
2025-10-07T04:31:53Z,article_selection,gpt-4.1-mini,1817,12,1829
2025-10-07T04:31:54Z,article_selection,gpt-4.1-mini,1215,9,1224
2025-10-07T04:31:54Z,article_selection,gpt-4.1-mini,403,3,406
2025-10-07T04:31:55Z,article_selection,gpt-4.1-mini,819,12,831
2025-10-07T04:31:55Z,article_selection,gpt-4.1-mini,1674,12,1686
2025-10-07T04:31:56Z,article_selection,gpt-4.1-mini,683,12,695
2025-10-07T04:32:13Z,final_summary_en,gpt-4.1-mini,1586,1155,2741
2025-10-07T04:32:31Z,final_summary_en,gpt-4.1-mini,1589,1062,2651
2025-10-07T04:32:48Z,final_summary_en,gpt-4.1-mini,1529,1147,2676
2025-10-07T04:33:06Z,final_summary_en,gpt-4.1-mini,1311,1148,2459
2025-10-07T04:33:27Z,final_summary_en,gpt-4.1-mini,1602,1287,2889
2025-10-07T04:33:44Z,final_summary_en,gpt-4.1-mini,1336,1114,2450
2025-10-07T04:34:02Z,final_summary_en,gpt-4.1-mini,1069,1234,2303
2025-10-07T04:34:28Z,final_summary_en,gpt-4.1-mini,1856,1241,3097
2025-10-07T04:34:49Z,final_summary_en,gpt-4.1-mini,2174,1293,3467
2025-10-07T04:35:09Z,final_summary_en,gpt-4.1-mini,1547,1056,2603
2025-10-07T04:35:28Z,final_summary_en,gpt-4.1-mini,1865,1231,3096
2025-10-07T04:35:47Z,final_summary_en,gpt-4.1-mini,1315,1255,2570
2025-10-07T04:36:06Z,final_summary_en,gpt-4.1-mini,1960,1194,3154
2025-10-07T04:36:22Z,final_summary_en,gpt-4.1-mini,2418,1089,3507
2025-10-07T04:36:40Z,final_summary_en,gpt-4.1-mini,1264,1211,2475
2025-10-07T04:36:59Z,final_summary_en,gpt-4.1-mini,1315,1146,2461
2025-10-07T04:37:17Z,final_summary_en,gpt-4.1-mini,1204,970,2174
2025-10-07T04:37:37Z,final_summary_en,gpt-4.1-mini,1679,1327,3006
2025-10-07T04:37:57Z,final_summary_en,gpt-4.1-mini,1583,1115,2698
2025-10-07T04:38:16Z,final_summary_en,gpt-4.1-mini,1862,1150,3012
2025-10-07T04:38:35Z,final_summary_en,gpt-4.1-mini,839,1166,2005
2025-10-07T04:39:38Z,category_summary,gpt-4.1-mini,132,50,182
2025-10-07T04:39:41Z,category_summary,gpt-4.1-mini,138,30,168
2025-10-07T04:39:43Z,category_summary,gpt-4.1-mini,90,26,116
2025-10-07T04:39:45Z,category_summary,gpt-4.1-mini,126,36,162
2025-10-07T04:39:48Z,category_summary,gpt-4.1-mini,131,47,178
2025-10-07T04:39:51Z,category_summary,gpt-4.1-mini,149,30,179
2025-10-07T04:39:52Z,RUN_TOTAL,,149782,33997,183779
2025-10-08T04:25:22Z,pre_sentiment,gpt-4.1-mini,280,1,281
2025-10-08T04:25:23Z,pre_sentiment,gpt-4.1-mini,286,1,287
2025-10-08T04:25:24Z,pre_sentiment,gpt-4.1-mini,286,1,287
2025-10-08T04:25:25Z,pre_sentiment,gpt-4.1-mini,286,1,287
2025-10-08T04:25:27Z,pre_sentiment,gpt-4.1-mini,282,1,283
2025-10-08T04:25:30Z,sentiment,gpt-4.1-mini,2194,193,2387
2025-10-08T04:25:31Z,pre_sentiment,gpt-4.1-mini,281,1,282
2025-10-08T04:25:31Z,pre_sentiment,gpt-4.1-mini,285,1,286
2025-10-08T04:25:32Z,pre_sentiment,gpt-4.1-mini,285,1,286
2025-10-08T04:25:32Z,pre_sentiment,gpt-4.1-mini,283,1,284
2025-10-08T04:25:33Z,pre_sentiment,gpt-4.1-mini,287,1,288
2025-10-08T04:25:33Z,pre_sentiment,gpt-4.1-mini,281,1,282
2025-10-08T04:25:33Z,pre_sentiment,gpt-4.1-mini,286,1,287
2025-10-08T04:25:34Z,pre_sentiment,gpt-4.1-mini,297,1,298
2025-10-08T04:25:34Z,pre_sentiment,gpt-4.1-mini,286,1,287
2025-10-08T04:25:36Z,pre_sentiment,gpt-4.1-mini,293,1,294
2025-10-08T04:25:42Z,pre_sentiment,gpt-4.1-mini,281,1,282
2025-10-08T04:25:42Z,pre_sentiment,gpt-4.1-mini,288,1,289
2025-10-08T04:25:43Z,pre_sentiment,gpt-4.1-mini,284,1,285
2025-10-08T04:25:43Z,pre_sentiment,gpt-4.1-mini,280,1,281
2025-10-08T04:25:46Z,sentiment,gpt-4.1-mini,1243,205,1448
2025-10-08T04:25:47Z,pre_sentiment,gpt-4.1-mini,281,1,282
2025-10-08T04:25:53Z,pre_sentiment,gpt-4.1-mini,286,1,287
2025-10-08T04:25:54Z,pre_sentiment,gpt-4.1-mini,287,1,288
2025-10-08T04:25:56Z,sentiment,gpt-4.1-mini,983,121,1104
2025-10-08T04:25:56Z,pre_sentiment,gpt-4.1-mini,276,1,277
2025-10-08T04:25:59Z,sentiment,gpt-4.1-mini,1420,170,1590
2025-10-08T04:26:04Z,pre_sentiment,gpt-4.1-mini,287,1,288
2025-10-08T04:26:06Z,sentiment,gpt-4.1-mini,1289,136,1425
2025-10-08T04:26:07Z,pre_sentiment,gpt-4.1-mini,281,1,282
2025-10-08T04:26:10Z,sentiment,gpt-4.1-mini,1478,191,1669
2025-10-08T04:26:10Z,pre_sentiment,gpt-4.1-mini,276,1,277
2025-10-08T04:26:14Z,sentiment,gpt-4.1-mini,1652,209,1861
2025-10-08T04:26:14Z,pre_sentiment,gpt-4.1-mini,287,1,288
2025-10-08T04:26:17Z,sentiment,gpt-4.1-mini,1764,210,1974
2025-10-08T04:26:18Z,pre_sentiment,gpt-4.1-mini,280,1,281
2025-10-08T04:26:18Z,pre_sentiment,gpt-4.1-mini,275,1,276
2025-10-08T04:26:22Z,sentiment,gpt-4.1-mini,1416,236,1652
2025-10-08T04:26:22Z,pre_sentiment,gpt-4.1-mini,284,1,285
2025-10-08T04:26:26Z,sentiment,gpt-4.1-mini,1299,179,1478
2025-10-08T04:26:26Z,pre_sentiment,gpt-4.1-mini,282,1,283
2025-10-08T04:26:29Z,sentiment,gpt-4.1-mini,1640,174,1814
2025-10-08T04:26:30Z,pre_sentiment,gpt-4.1-mini,286,1,287
2025-10-08T04:26:34Z,sentiment,gpt-4.1-mini,2035,202,2237
2025-10-08T04:26:35Z,pre_sentiment,gpt-4.1-mini,277,1,278
2025-10-08T04:26:39Z,sentiment,gpt-4.1-mini,1497,174,1671
2025-10-08T04:26:55Z,pre_sentiment,gpt-4.1-mini,291,1,292
2025-10-08T04:26:56Z,sentiment,gpt-4.1-mini,899,84,983
2025-10-08T04:26:57Z,pre_sentiment,gpt-4.1-mini,291,1,292
2025-10-08T04:26:59Z,sentiment,gpt-4.1-mini,899,88,987
2025-10-08T04:26:59Z,pre_sentiment,gpt-4.1-mini,305,1,306
2025-10-08T04:27:01Z,sentiment,gpt-4.1-mini,943,109,1052
2025-10-08T04:27:01Z,pre_sentiment,gpt-4.1-mini,292,1,293
2025-10-08T04:27:03Z,sentiment,gpt-4.1-mini,900,83,983
2025-10-08T04:27:03Z,pre_sentiment,gpt-4.1-mini,294,1,295
2025-10-08T04:27:05Z,sentiment,gpt-4.1-mini,904,88,992
2025-10-08T04:27:06Z,pre_sentiment,gpt-4.1-mini,296,1,297
2025-10-08T04:27:09Z,sentiment,gpt-4.1-mini,1730,180,1910
2025-10-08T04:27:09Z,pre_sentiment,gpt-4.1-mini,297,1,298
2025-10-08T04:27:09Z,pre_sentiment,gpt-4.1-mini,298,1,299
2025-10-08T04:27:13Z,sentiment,gpt-4.1-mini,1406,203,1609
2025-10-08T04:27:14Z,pre_sentiment,gpt-4.1-mini,301,1,302
2025-10-08T04:27:18Z,sentiment,gpt-4.1-mini,1689,158,1847
2025-10-08T04:27:18Z,pre_sentiment,gpt-4.1-mini,300,1,301
2025-10-08T04:27:20Z,sentiment,gpt-4.1-mini,1790,144,1934
2025-10-08T04:27:21Z,pre_sentiment,gpt-4.1-mini,298,1,299
2025-10-08T04:27:26Z,sentiment,gpt-4.1-mini,1972,201,2173
2025-10-08T04:27:26Z,pre_sentiment,gpt-4.1-mini,292,1,293
2025-10-08T04:27:29Z,sentiment,gpt-4.1-mini,1595,168,1763
2025-10-08T04:27:30Z,pre_sentiment,gpt-4.1-mini,298,1,299
2025-10-08T04:27:33Z,sentiment,gpt-4.1-mini,1095,185,1280
2025-10-08T04:27:55Z,pre_sentiment,gpt-4.1-mini,280,1,281
2025-10-08T04:27:57Z,sentiment,gpt-4.1-mini,2216,137,2353
2025-10-08T04:27:58Z,pre_sentiment,gpt-4.1-mini,283,1,284
2025-10-08T04:28:03Z,sentiment,gpt-4.1-mini,2549,220,2769
2025-10-08T04:28:11Z,pre_sentiment,gpt-4.1-mini,285,1,286
2025-10-08T04:28:17Z,sentiment,gpt-4.1-mini,6082,251,6333
2025-10-08T04:28:22Z,pre_sentiment,gpt-4.1-mini,273,1,274
2025-10-08T04:28:22Z,pre_sentiment,gpt-4.1-mini,277,1,278
2025-10-08T04:28:23Z,pre_sentiment,gpt-4.1-mini,274,1,275
2025-10-08T04:28:23Z,pre_sentiment,gpt-4.1-mini,273,1,274
2025-10-08T04:28:35Z,pre_sentiment,gpt-4.1-mini,283,1,284
2025-10-08T04:28:39Z,sentiment,gpt-4.1-mini,1652,188,1840
2025-10-08T04:28:39Z,pre_sentiment,gpt-4.1-mini,280,1,281
2025-10-08T04:28:42Z,sentiment,gpt-4.1-mini,3049,148,3197
2025-10-08T04:28:42Z,pre_sentiment,gpt-4.1-mini,287,1,288
2025-10-08T04:28:46Z,sentiment,gpt-4.1-mini,3899,242,4141
2025-10-08T04:28:46Z,pre_sentiment,gpt-4.1-mini,285,1,286
2025-10-08T04:28:50Z,sentiment,gpt-4.1-mini,1354,203,1557
2025-10-08T04:28:50Z,pre_sentiment,gpt-4.1-mini,287,1,288
2025-10-08T04:28:54Z,sentiment,gpt-4.1-mini,1525,187,1712
2025-10-08T04:29:10Z,pre_sentiment,gpt-4.1-mini,284,1,285
2025-10-08T04:29:11Z,pre_sentiment,gpt-4.1-mini,286,1,287
2025-10-08T04:29:13Z,sentiment,gpt-4.1-mini,1130,124,1254
2025-10-08T04:29:36Z,pre_sentiment,gpt-4.1-mini,289,1,290
2025-10-08T04:29:40Z,sentiment,gpt-4.1-mini,1600,181,1781
2025-10-08T04:29:41Z,pre_sentiment,gpt-4.1-mini,287,1,288
2025-10-08T04:29:44Z,sentiment,gpt-4.1-mini,1812,172,1984
2025-10-08T04:29:44Z,pre_sentiment,gpt-4.1-mini,298,1,299
2025-10-08T04:29:47Z,sentiment,gpt-4.1-mini,1705,165,1870
2025-10-08T04:29:56Z,pre_sentiment,gpt-4.1-mini,293,1,294
2025-10-08T04:30:00Z,sentiment,gpt-4.1-mini,1842,235,2077
2025-10-08T04:30:00Z,pre_sentiment,gpt-4.1-mini,291,1,292
2025-10-08T04:30:03Z,sentiment,gpt-4.1-mini,1221,142,1363
2025-10-08T04:30:04Z,pre_sentiment,gpt-4.1-mini,279,1,280
2025-10-08T04:30:04Z,pre_sentiment,gpt-4.1-mini,272,1,273
2025-10-08T04:30:07Z,sentiment,gpt-4.1-mini,1684,175,1859
2025-10-08T04:30:15Z,pre_sentiment,gpt-4.1-mini,279,1,280
2025-10-08T04:30:15Z,pre_sentiment,gpt-4.1-mini,287,1,288
2025-10-08T04:30:18Z,sentiment,gpt-4.1-mini,1351,174,1525
2025-10-08T04:30:19Z,pre_sentiment,gpt-4.1-mini,287,1,288
2025-10-08T04:30:23Z,sentiment,gpt-4.1-mini,1470,193,1663
2025-10-08T04:30:23Z,pre_sentiment,gpt-4.1-mini,285,1,286
2025-10-08T04:30:24Z,pre_sentiment,gpt-4.1-mini,290,1,291
2025-10-08T04:30:24Z,pre_sentiment,gpt-4.1-mini,293,1,294
2025-10-08T04:30:39Z,pre_sentiment,gpt-4.1-mini,299,1,300
2025-10-08T04:30:45Z,sentiment,gpt-4.1-mini,2484,229,2713
2025-10-08T04:30:46Z,pre_sentiment,gpt-4.1-mini,283,1,284
2025-10-08T04:30:46Z,pre_sentiment,gpt-4.1-mini,285,1,286
2025-10-08T04:30:50Z,sentiment,gpt-4.1-mini,2882,150,3032
2025-10-08T04:31:03Z,pre_sentiment,gpt-4.1-mini,286,1,287
2025-10-08T04:31:04Z,pre_sentiment,gpt-4.1-mini,285,1,286
2025-10-08T04:31:04Z,pre_sentiment,gpt-4.1-mini,291,1,292
2025-10-08T04:31:08Z,sentiment,gpt-4.1-mini,1603,205,1808
2025-10-08T04:31:08Z,pre_sentiment,gpt-4.1-mini,282,1,283
2025-10-08T04:31:08Z,pre_sentiment,gpt-4.1-mini,283,1,284
2025-10-08T04:31:09Z,pre_sentiment,gpt-4.1-mini,286,1,287
2025-10-08T04:31:16Z,sentiment,gpt-4.1-mini,1505,218,1723
2025-10-08T04:31:17Z,pre_sentiment,gpt-4.1-mini,294,1,295
2025-10-08T04:31:23Z,sentiment,gpt-4.1-mini,1314,209,1523
2025-10-08T04:31:23Z,pre_sentiment,gpt-4.1-mini,288,1,289
2025-10-08T04:31:23Z,pre_sentiment,gpt-4.1-mini,287,1,288
2025-10-08T04:31:27Z,sentiment,gpt-4.1-mini,1219,137,1356
2025-10-08T04:31:27Z,pre_sentiment,gpt-4.1-mini,285,1,286
2025-10-08T04:31:27Z,pre_sentiment,gpt-4.1-mini,288,1,289
2025-10-08T04:31:31Z,sentiment,gpt-4.1-mini,1235,183,1418
2025-10-08T04:31:31Z,pre_sentiment,gpt-4.1-mini,281,1,282
2025-10-08T04:31:46Z,article_selection,gpt-4.1-mini,1514,12,1526
2025-10-08T04:31:46Z,article_selection,gpt-4.1-mini,978,12,990
2025-10-08T04:31:47Z,article_selection,gpt-4.1-mini,1474,12,1486
2025-10-08T04:31:48Z,article_selection,gpt-4.1-mini,793,12,805
2025-10-08T04:31:48Z,article_selection,gpt-4.1-mini,383,5,388
2025-10-08T04:31:59Z,final_summary_en,gpt-4.1-mini,1401,1088,2489
2025-10-08T04:32:12Z,final_summary_en,gpt-4.1-mini,1039,1080,2119
2025-10-08T04:32:26Z,final_summary_en,gpt-4.1-mini,1369,1093,2462
2025-10-08T04:32:37Z,final_summary_en,gpt-4.1-mini,1786,1057,2843
2025-10-08T04:32:48Z,final_summary_en,gpt-4.1-mini,1526,935,2461
2025-10-08T04:33:01Z,final_summary_en,gpt-4.1-mini,1160,1162,2322
2025-10-08T04:33:14Z,final_summary_en,gpt-4.1-mini,1224,1037,2261
2025-10-08T04:33:26Z,final_summary_en,gpt-4.1-mini,1729,952,2681
2025-10-08T04:33:42Z,final_summary_en,gpt-4.1-mini,1180,1158,2338
2025-10-08T04:33:54Z,final_summary_en,gpt-4.1-mini,1237,1163,2400
2025-10-08T04:34:09Z,final_summary_en,gpt-4.1-mini,5860,1393,7253
2025-10-08T04:34:19Z,final_summary_en,gpt-4.1-mini,1117,885,2002
2025-10-08T04:34:29Z,final_summary_en,gpt-4.1-mini,1254,1001,2255
2025-10-08T04:34:41Z,final_summary_en,gpt-4.1-mini,1610,1121,2731
2025-10-08T04:34:53Z,final_summary_en,gpt-4.1-mini,1232,1035,2267
2025-10-08T04:35:07Z,final_summary_en,gpt-4.1-mini,981,1130,2111
2025-10-08T04:35:21Z,final_summary_en,gpt-4.1-mini,1955,1057,3012
2025-10-08T04:35:34Z,final_summary_en,gpt-4.1-mini,1080,1167,2247
2025-10-08T04:36:26Z,category_summary,gpt-4.1-mini,127,33,160
2025-10-08T04:36:28Z,category_summary,gpt-4.1-mini,123,26,149
2025-10-08T04:36:30Z,category_summary,gpt-4.1-mini,133,30,163
2025-10-08T04:36:32Z,category_summary,gpt-4.1-mini,144,27,171
2025-10-08T04:36:34Z,category_summary,gpt-4.1-mini,108,21,129
2025-10-08T04:36:35Z,RUN_TOTAL,,143817,28351,172168
2025-10-09T04:25:40Z,pre_sentiment,gpt-4.1-mini,293,1,294
2025-10-09T04:25:44Z,sentiment,gpt-4.1-mini,1917,230,2147
2025-10-09T04:25:45Z,pre_sentiment,gpt-4.1-mini,282,1,283
2025-10-09T04:25:45Z,pre_sentiment,gpt-4.1-mini,281,1,282
2025-10-09T04:25:46Z,pre_sentiment,gpt-4.1-mini,286,1,287
2025-10-09T04:25:47Z,pre_sentiment,gpt-4.1-mini,279,1,280
2025-10-09T04:25:53Z,pre_sentiment,gpt-4.1-mini,291,1,292
2025-10-09T04:25:53Z,pre_sentiment,gpt-4.1-mini,279,1,280
2025-10-09T04:25:56Z,sentiment,gpt-4.1-mini,1283,154,1437
2025-10-09T04:25:57Z,pre_sentiment,gpt-4.1-mini,283,1,284
2025-10-09T04:25:57Z,pre_sentiment,gpt-4.1-mini,283,1,284
2025-10-09T04:25:58Z,pre_sentiment,gpt-4.1-mini,282,1,283
2025-10-09T04:26:00Z,sentiment,gpt-4.1-mini,1581,165,1746
2025-10-09T04:26:01Z,pre_sentiment,gpt-4.1-mini,285,1,286
2025-10-09T04:26:01Z,pre_sentiment,gpt-4.1-mini,287,1,288
2025-10-09T04:26:01Z,pre_sentiment,gpt-4.1-mini,290,1,291
2025-10-09T04:26:02Z,pre_sentiment,gpt-4.1-mini,287,1,288
2025-10-09T04:26:02Z,pre_sentiment,gpt-4.1-mini,291,1,292
2025-10-09T04:26:10Z,pre_sentiment,gpt-4.1-mini,285,1,286
2025-10-09T04:26:10Z,pre_sentiment,gpt-4.1-mini,279,1,280
2025-10-09T04:26:20Z,pre_sentiment,gpt-4.1-mini,279,1,280
2025-10-09T04:26:23Z,sentiment,gpt-4.1-mini,1449,208,1657
2025-10-09T04:26:23Z,pre_sentiment,gpt-4.1-mini,286,1,287
2025-10-09T04:26:24Z,pre_sentiment,gpt-4.1-mini,285,1,286
2025-10-09T04:26:26Z,sentiment,gpt-4.1-mini,963,122,1085
2025-10-09T04:26:31Z,pre_sentiment,gpt-4.1-mini,285,1,286
2025-10-09T04:26:35Z,sentiment,gpt-4.1-mini,1598,164,1762
2025-10-09T04:26:35Z,pre_sentiment,gpt-4.1-mini,281,1,282
2025-10-09T04:26:38Z,sentiment,gpt-4.1-mini,2259,195,2454
2025-10-09T04:26:38Z,pre_sentiment,gpt-4.1-mini,286,1,287
2025-10-09T04:26:42Z,sentiment,gpt-4.1-mini,1496,247,1743
2025-10-09T04:26:43Z,pre_sentiment,gpt-4.1-mini,281,1,282
2025-10-09T04:26:46Z,sentiment,gpt-4.1-mini,2567,225,2792
2025-10-09T04:26:47Z,pre_sentiment,gpt-4.1-mini,288,1,289
2025-10-09T04:26:49Z,sentiment,gpt-4.1-mini,1752,173,1925
2025-10-09T04:26:50Z,pre_sentiment,gpt-4.1-mini,279,1,280
2025-10-09T04:26:53Z,sentiment,gpt-4.1-mini,1540,185,1725
2025-10-09T04:26:53Z,pre_sentiment,gpt-4.1-mini,281,1,282
2025-10-09T04:26:53Z,pre_sentiment,gpt-4.1-mini,287,1,288
2025-10-09T04:26:56Z,sentiment,gpt-4.1-mini,1289,151,1440
2025-10-09T04:26:56Z,pre_sentiment,gpt-4.1-mini,279,1,280
2025-10-09T04:27:00Z,sentiment,gpt-4.1-mini,1391,164,1555
2025-10-09T04:27:01Z,pre_sentiment,gpt-4.1-mini,284,1,285
2025-10-09T04:27:04Z,sentiment,gpt-4.1-mini,1564,205,1769
2025-10-09T04:27:04Z,pre_sentiment,gpt-4.1-mini,280,1,281
2025-10-09T04:27:07Z,sentiment,gpt-4.1-mini,1673,197,1870
2025-10-09T04:27:07Z,pre_sentiment,gpt-4.1-mini,286,1,287
2025-10-09T04:27:10Z,sentiment,gpt-4.1-mini,1605,189,1794
2025-10-09T04:27:11Z,pre_sentiment,gpt-4.1-mini,283,1,284
2025-10-09T04:27:14Z,sentiment,gpt-4.1-mini,1825,193,2018
2025-10-09T04:27:33Z,pre_sentiment,gpt-4.1-mini,295,1,296
2025-10-09T04:27:36Z,sentiment,gpt-4.1-mini,1127,173,1300
2025-10-09T04:27:36Z,pre_sentiment,gpt-4.1-mini,299,1,300
2025-10-09T04:27:39Z,sentiment,gpt-4.1-mini,1393,178,1571
2025-10-09T04:27:39Z,pre_sentiment,gpt-4.1-mini,297,1,298
2025-10-09T04:27:42Z,sentiment,gpt-4.1-mini,1058,158,1216
2025-10-09T04:27:42Z,pre_sentiment,gpt-4.1-mini,298,1,299
2025-10-09T04:27:45Z,sentiment,gpt-4.1-mini,16722,223,16945
2025-10-09T04:27:46Z,pre_sentiment,gpt-4.1-mini,299,1,300
2025-10-09T04:27:48Z,sentiment,gpt-4.1-mini,3625,176,3801
2025-10-09T04:27:49Z,pre_sentiment,gpt-4.1-mini,296,1,297
2025-10-09T04:27:53Z,sentiment,gpt-4.1-mini,8020,273,8293
2025-10-09T04:27:53Z,pre_sentiment,gpt-4.1-mini,303,1,304
2025-10-09T04:27:56Z,sentiment,gpt-4.1-mini,2651,197,2848
2025-10-09T04:27:56Z,pre_sentiment,gpt-4.1-mini,295,1,296
2025-10-09T04:28:01Z,sentiment,gpt-4.1-mini,9224,276,9500
2025-10-09T04:28:01Z,pre_sentiment,gpt-4.1-mini,293,1,294
2025-10-09T04:28:06Z,sentiment,gpt-4.1-mini,14162,315,14477
2025-10-09T04:28:07Z,pre_sentiment,gpt-4.1-mini,298,1,299
2025-10-09T04:28:10Z,sentiment,gpt-4.1-mini,5499,232,5731
2025-10-09T04:28:10Z,pre_sentiment,gpt-4.1-mini,302,1,303
2025-10-09T04:28:14Z,sentiment,gpt-4.1-mini,6108,265,6373
2025-10-09T04:28:14Z,pre_sentiment,gpt-4.1-mini,302,1,303
2025-10-09T04:28:18Z,sentiment,gpt-4.1-mini,5802,221,6023
2025-10-09T04:28:18Z,pre_sentiment,gpt-4.1-mini,298,1,299
2025-10-09T04:28:21Z,sentiment,gpt-4.1-mini,5278,195,5473
2025-10-09T04:28:21Z,pre_sentiment,gpt-4.1-mini,297,1,298
2025-10-09T04:28:23Z,sentiment,gpt-4.1-mini,1138,170,1308
2025-10-09T04:28:24Z,pre_sentiment,gpt-4.1-mini,304,1,305
2025-10-09T04:28:27Z,sentiment,gpt-4.1-mini,5996,188,6184
2025-10-09T04:28:40Z,pre_sentiment,gpt-4.1-mini,288,1,289
2025-10-09T04:28:44Z,sentiment,gpt-4.1-mini,2027,214,2241
2025-10-09T04:28:55Z,pre_sentiment,gpt-4.1-mini,286,1,287
2025-10-09T04:28:56Z,pre_sentiment,gpt-4.1-mini,294,1,295
2025-10-09T04:28:58Z,sentiment,gpt-4.1-mini,1214,179,1393
2025-10-09T04:29:08Z,pre_sentiment,gpt-4.1-mini,283,1,284
2025-10-09T04:29:11Z,sentiment,gpt-4.1-mini,6491,214,6705
2025-10-09T04:29:18Z,pre_sentiment,gpt-4.1-mini,263,1,264
2025-10-09T04:29:19Z,pre_sentiment,gpt-4.1-mini,281,1,282
2025-10-09T04:29:19Z,pre_sentiment,gpt-4.1-mini,276,1,277
2025-10-09T04:29:20Z,pre_sentiment,gpt-4.1-mini,272,1,273
2025-10-09T04:29:20Z,pre_sentiment,gpt-4.1-mini,275,1,276
2025-10-09T04:29:23Z,sentiment,gpt-4.1-mini,1850,170,2020
2025-10-09T04:29:23Z,pre_sentiment,gpt-4.1-mini,277,1,278
2025-10-09T04:29:23Z,pre_sentiment,gpt-4.1-mini,271,1,272
2025-10-09T04:29:24Z,pre_sentiment,gpt-4.1-mini,270,1,271
2025-10-09T04:29:27Z,sentiment,gpt-4.1-mini,1882,204,2086
2025-10-09T04:29:27Z,pre_sentiment,gpt-4.1-mini,273,1,274
2025-10-09T04:29:38Z,pre_sentiment,gpt-4.1-mini,281,1,282
2025-10-09T04:29:41Z,sentiment,gpt-4.1-mini,1479,178,1657
2025-10-09T04:29:42Z,pre_sentiment,gpt-4.1-mini,284,1,285
2025-10-09T04:29:46Z,sentiment,gpt-4.1-mini,1401,212,1613
2025-10-09T04:29:46Z,pre_sentiment,gpt-4.1-mini,286,1,287
2025-10-09T04:29:49Z,sentiment,gpt-4.1-mini,1519,183,1702
2025-10-09T04:29:49Z,pre_sentiment,gpt-4.1-mini,284,1,285
2025-10-09T04:29:49Z,pre_sentiment,gpt-4.1-mini,282,1,283
2025-10-09T04:29:53Z,sentiment,gpt-4.1-mini,2696,212,2908
2025-10-09T04:29:53Z,pre_sentiment,gpt-4.1-mini,284,1,285
2025-10-09T04:29:57Z,sentiment,gpt-4.1-mini,1466,181,1647
2025-10-09T04:30:09Z,pre_sentiment,gpt-4.1-mini,288,1,289
2025-10-09T04:30:12Z,sentiment,gpt-4.1-mini,1077,136,1213
2025-10-09T04:30:20Z,pre_sentiment,gpt-4.1-mini,288,1,289
2025-10-09T04:30:22Z,sentiment,gpt-4.1-mini,1035,120,1155
2025-10-09T04:30:22Z,pre_sentiment,gpt-4.1-mini,278,1,279
2025-10-09T04:30:24Z,sentiment,gpt-4.1-mini,1223,118,1341
2025-10-09T04:30:50Z,pre_sentiment,gpt-4.1-mini,290,1,291
2025-10-09T04:30:54Z,sentiment,gpt-4.1-mini,1721,200,1921
2025-10-09T04:30:55Z,pre_sentiment,gpt-4.1-mini,290,1,291
2025-10-09T04:30:55Z,pre_sentiment,gpt-4.1-mini,289,1,290
2025-10-09T04:30:58Z,sentiment,gpt-4.1-mini,1600,176,1776
2025-10-09T04:30:59Z,pre_sentiment,gpt-4.1-mini,287,1,288
2025-10-09T04:31:02Z,sentiment,gpt-4.1-mini,1812,208,2020
2025-10-09T04:31:10Z,pre_sentiment,gpt-4.1-mini,288,1,289
2025-10-09T04:31:13Z,sentiment,gpt-4.1-mini,1238,189,1427
2025-10-09T04:31:14Z,pre_sentiment,gpt-4.1-mini,290,1,291
2025-10-09T04:31:17Z,sentiment,gpt-4.1-mini,1138,186,1324
2025-10-09T04:31:17Z,pre_sentiment,gpt-4.1-mini,294,1,295
2025-10-09T04:31:21Z,sentiment,gpt-4.1-mini,1212,171,1383
2025-10-09T04:31:21Z,pre_sentiment,gpt-4.1-mini,282,1,283
2025-10-09T04:31:24Z,sentiment,gpt-4.1-mini,1244,191,1435
2025-10-09T04:31:24Z,pre_sentiment,gpt-4.1-mini,272,1,273
2025-10-09T04:31:26Z,sentiment,gpt-4.1-mini,1671,128,1799
2025-10-09T04:31:35Z,pre_sentiment,gpt-4.1-mini,287,1,288
2025-10-09T04:31:36Z,pre_sentiment,gpt-4.1-mini,284,1,285
2025-10-09T04:31:36Z,pre_sentiment,gpt-4.1-mini,283,1,284
2025-10-09T04:31:36Z,pre_sentiment,gpt-4.1-mini,284,1,285
2025-10-09T04:31:37Z,pre_sentiment,gpt-4.1-mini,280,1,281
2025-10-09T04:31:40Z,sentiment,gpt-4.1-mini,1370,238,1608
2025-10-09T04:31:41Z,pre_sentiment,gpt-4.1-mini,286,1,287
2025-10-09T04:31:44Z,sentiment,gpt-4.1-mini,1529,155,1684
2025-10-09T04:31:44Z,pre_sentiment,gpt-4.1-mini,288,1,289
2025-10-09T04:31:45Z,pre_sentiment,gpt-4.1-mini,287,1,288
2025-10-09T04:31:48Z,sentiment,gpt-4.1-mini,3343,218,3561
2025-10-09T04:32:02Z,pre_sentiment,gpt-4.1-mini,299,1,300
2025-10-09T04:32:06Z,sentiment,gpt-4.1-mini,2484,252,2736
2025-10-09T04:32:06Z,pre_sentiment,gpt-4.1-mini,281,1,282
2025-10-09T04:32:19Z,pre_sentiment,gpt-4.1-mini,278,1,279
2025-10-09T04:32:22Z,sentiment,gpt-4.1-mini,1133,213,1346
2025-10-09T04:32:22Z,pre_sentiment,gpt-4.1-mini,282,1,283
2025-10-09T04:32:23Z,pre_sentiment,gpt-4.1-mini,279,1,280
2025-10-09T04:32:26Z,sentiment,gpt-4.1-mini,1085,188,1273
2025-10-09T04:32:26Z,pre_sentiment,gpt-4.1-mini,280,1,281
2025-10-09T04:32:26Z,pre_sentiment,gpt-4.1-mini,289,1,290
2025-10-09T04:32:27Z,pre_sentiment,gpt-4.1-mini,297,1,298
2025-10-09T04:32:27Z,pre_sentiment,gpt-4.1-mini,300,1,301
2025-10-09T04:32:28Z,pre_sentiment,gpt-4.1-mini,293,1,294
2025-10-09T04:32:30Z,sentiment,gpt-4.1-mini,1572,135,1707
2025-10-09T04:32:30Z,pre_sentiment,gpt-4.1-mini,287,1,288
2025-10-09T04:32:32Z,sentiment,gpt-4.1-mini,1164,167,1331
2025-10-09T04:32:33Z,pre_sentiment,gpt-4.1-mini,282,1,283
2025-10-09T04:32:37Z,sentiment,gpt-4.1-mini,1158,183,1341
2025-10-09T04:32:37Z,pre_sentiment,gpt-4.1-mini,285,1,286
2025-10-09T04:32:41Z,sentiment,gpt-4.1-mini,1492,212,1704
2025-10-09T04:32:41Z,pre_sentiment,gpt-4.1-mini,287,1,288
2025-10-09T04:32:41Z,pre_sentiment,gpt-4.1-mini,286,1,287
2025-10-09T04:32:42Z,pre_sentiment,gpt-4.1-mini,292,1,293
2025-10-09T04:32:45Z,sentiment,gpt-4.1-mini,1231,207,1438
2025-10-09T04:32:45Z,pre_sentiment,gpt-4.1-mini,281,1,282
2025-10-09T04:33:07Z,article_selection,gpt-4.1-mini,1802,9,1811
2025-10-09T04:33:07Z,article_selection,gpt-4.1-mini,1376,12,1388
2025-10-09T04:33:08Z,article_selection,gpt-4.1-mini,1436,12,1448
2025-10-09T04:33:08Z,article_selection,gpt-4.1-mini,2513,9,2522
2025-10-09T04:33:09Z,article_selection,gpt-4.1-mini,757,16,773
2025-10-09T04:33:22Z,final_summary_en,gpt-4.1-mini,1283,985,2268
2025-10-09T04:33:34Z,final_summary_en,gpt-4.1-mini,1341,1045,2386
2025-10-09T04:33:46Z,final_summary_en,gpt-4.1-mini,2003,1053,3056
2025-10-09T04:33:59Z,final_summary_en,gpt-4.1-mini,2316,1159,3475
2025-10-09T04:34:11Z,final_summary_en,gpt-4.1-mini,1776,949,2725
2025-10-09T04:34:24Z,final_summary_en,gpt-4.1-mini,949,1114,2063
2025-10-09T04:34:36Z,final_summary_en,gpt-4.1-mini,1202,1125,2327
2025-10-09T04:34:48Z,final_summary_en,gpt-4.1-mini,797,909,1706
2025-10-09T04:35:03Z,final_summary_en,gpt-4.1-mini,1212,1093,2305
2025-10-09T04:35:14Z,final_summary_en,gpt-4.1-mini,1127,1022,2149
2025-10-09T04:35:26Z,final_summary_en,gpt-4.1-mini,1427,1073,2500
2025-10-09T04:35:43Z,final_summary_en,gpt-4.1-mini,13980,1359,15339
2025-10-09T04:36:00Z,final_summary_en,gpt-4.1-mini,3103,1290,4393
2025-10-09T04:36:16Z,final_summary_en,gpt-4.1-mini,1686,1186,2872
2025-10-09T04:36:31Z,final_summary_en,gpt-4.1-mini,1485,1066,2551
2025-10-09T04:36:43Z,final_summary_en,gpt-4.1-mini,898,985,1883
2025-10-09T04:36:58Z,final_summary_en,gpt-4.1-mini,1499,1183,2682
2025-10-09T04:37:10Z,final_summary_en,gpt-4.1-mini,1581,1099,2680
2025-10-09T04:37:29Z,final_summary_en,gpt-4.1-mini,1356,1196,2552
2025-10-09T04:37:46Z,final_summary_en,gpt-4.1-mini,5576,1385,6961
2025-10-09T04:38:04Z,final_summary_en,gpt-4.1-mini,1269,1237,2506
2025-10-09T04:39:15Z,category_summary,gpt-4.1-mini,123,31,154
2025-10-09T04:39:17Z,category_summary,gpt-4.1-mini,144,28,172
2025-10-09T04:39:19Z,category_summary,gpt-4.1-mini,119,32,151
2025-10-09T04:39:21Z,category_summary,gpt-4.1-mini,136,42,178
2025-10-09T04:39:24Z,category_summary,gpt-4.1-mini,135,34,169
2025-10-09T04:39:26Z,category_summary,gpt-4.1-mini,89,27,116
2025-10-09T04:39:27Z,RUN_TOTAL,,256360,36214,292574
2025-10-10T04:25:19Z,pre_sentiment,gpt-4.1-mini,279,1,280
2025-10-10T04:25:20Z,pre_sentiment,gpt-4.1-mini,291,1,292
2025-10-10T04:25:25Z,sentiment,gpt-4.1-mini,3014,237,3251
2025-10-10T04:25:26Z,pre_sentiment,gpt-4.1-mini,276,1,277
2025-10-10T04:25:27Z,pre_sentiment,gpt-4.1-mini,287,1,288
2025-10-10T04:25:27Z,pre_sentiment,gpt-4.1-mini,282,1,283
2025-10-10T04:25:32Z,sentiment,gpt-4.1-mini,1557,202,1759
2025-10-10T04:25:32Z,pre_sentiment,gpt-4.1-mini,285,1,286
2025-10-10T04:25:32Z,pre_sentiment,gpt-4.1-mini,281,1,282
2025-10-10T04:25:35Z,sentiment,gpt-4.1-mini,1237,156,1393
2025-10-10T04:25:35Z,pre_sentiment,gpt-4.1-mini,279,1,280
2025-10-10T04:25:38Z,sentiment,gpt-4.1-mini,1822,176,1998
2025-10-10T04:25:38Z,pre_sentiment,gpt-4.1-mini,284,1,285
2025-10-10T04:25:38Z,pre_sentiment,gpt-4.1-mini,285,1,286
2025-10-10T04:25:40Z,pre_sentiment,gpt-4.1-mini,286,1,287
2025-10-10T04:25:42Z,sentiment,gpt-4.1-mini,1726,182,1908
2025-10-10T04:25:43Z,pre_sentiment,gpt-4.1-mini,283,1,284
2025-10-10T04:25:44Z,pre_sentiment,gpt-4.1-mini,282,1,283
2025-10-10T04:25:44Z,pre_sentiment,gpt-4.1-mini,279,1,280
2025-10-10T04:25:44Z,pre_sentiment,gpt-4.1-mini,291,1,292
2025-10-10T04:25:47Z,sentiment,gpt-4.1-mini,1681,201,1882
2025-10-10T04:25:52Z,pre_sentiment,gpt-4.1-mini,283,1,284
2025-10-10T04:25:53Z,pre_sentiment,gpt-4.1-mini,285,1,286
2025-10-10T04:25:53Z,pre_sentiment,gpt-4.1-mini,280,1,281
2025-10-10T04:25:54Z,pre_sentiment,gpt-4.1-mini,283,1,284
2025-10-10T04:25:54Z,pre_sentiment,gpt-4.1-mini,285,1,286
2025-10-10T04:25:54Z,pre_sentiment,gpt-4.1-mini,281,1,282
2025-10-10T04:25:59Z,pre_sentiment,gpt-4.1-mini,276,1,277
2025-10-10T04:26:02Z,sentiment,gpt-4.1-mini,1251,178,1429
2025-10-10T04:26:02Z,pre_sentiment,gpt-4.1-mini,279,1,280
2025-10-10T04:26:08Z,pre_sentiment,gpt-4.1-mini,284,1,285
2025-10-10T04:26:11Z,sentiment,gpt-4.1-mini,1830,174,2004
2025-10-10T04:26:12Z,pre_sentiment,gpt-4.1-mini,289,1,290
2025-10-10T04:26:15Z,sentiment,gpt-4.1-mini,1547,216,1763
2025-10-10T04:26:15Z,pre_sentiment,gpt-4.1-mini,284,1,285
2025-10-10T04:26:19Z,sentiment,gpt-4.1-mini,2199,236,2435
2025-10-10T04:26:19Z,pre_sentiment,gpt-4.1-mini,287,1,288
2025-10-10T04:26:22Z,sentiment,gpt-4.1-mini,1810,181,1991
2025-10-10T04:26:22Z,pre_sentiment,gpt-4.1-mini,285,1,286
2025-10-10T04:26:25Z,sentiment,gpt-4.1-mini,1559,168,1727
2025-10-10T04:26:25Z,pre_sentiment,gpt-4.1-mini,284,1,285
2025-10-10T04:26:28Z,sentiment,gpt-4.1-mini,1576,208,1784
2025-10-10T04:26:48Z,pre_sentiment,gpt-4.1-mini,298,1,299
2025-10-10T04:26:50Z,sentiment,gpt-4.1-mini,1287,173,1460
2025-10-10T04:26:51Z,pre_sentiment,gpt-4.1-mini,305,1,306
2025-10-10T04:26:51Z,pre_sentiment,gpt-4.1-mini,304,1,305
2025-10-10T04:26:54Z,sentiment,gpt-4.1-mini,1876,196,2072
2025-10-10T04:26:54Z,pre_sentiment,gpt-4.1-mini,299,1,300
2025-10-10T04:26:57Z,sentiment,gpt-4.1-mini,1570,228,1798
2025-10-10T04:26:58Z,pre_sentiment,gpt-4.1-mini,301,1,302
2025-10-10T04:27:00Z,sentiment,gpt-4.1-mini,1648,172,1820
2025-10-10T04:27:01Z,pre_sentiment,gpt-4.1-mini,294,1,295
2025-10-10T04:27:05Z,sentiment,gpt-4.1-mini,9653,221,9874
2025-10-10T04:27:06Z,pre_sentiment,gpt-4.1-mini,295,1,296
2025-10-10T04:27:08Z,sentiment,gpt-4.1-mini,1127,198,1325
2025-10-10T04:27:09Z,pre_sentiment,gpt-4.1-mini,299,1,300
2025-10-10T04:27:12Z,sentiment,gpt-4.1-mini,1393,167,1560
2025-10-10T04:27:12Z,pre_sentiment,gpt-4.1-mini,297,1,298
2025-10-10T04:27:15Z,sentiment,gpt-4.1-mini,1058,132,1190
2025-10-10T04:27:15Z,pre_sentiment,gpt-4.1-mini,298,1,299
2025-10-10T04:27:17Z,sentiment,gpt-4.1-mini,16722,239,16961
2025-10-10T04:27:18Z,pre_sentiment,gpt-4.1-mini,299,1,300
2025-10-10T04:27:20Z,sentiment,gpt-4.1-mini,3625,192,3817
2025-10-10T04:27:21Z,pre_sentiment,gpt-4.1-mini,296,1,297
2025-10-10T04:27:25Z,sentiment,gpt-4.1-mini,8020,281,8301
2025-10-10T04:27:26Z,pre_sentiment,gpt-4.1-mini,303,1,304
2025-10-10T04:27:29Z,sentiment,gpt-4.1-mini,2651,210,2861
2025-10-10T04:27:30Z,pre_sentiment,gpt-4.1-mini,295,1,296
2025-10-10T04:27:36Z,sentiment,gpt-4.1-mini,9224,295,9519
2025-10-10T04:27:59Z,pre_sentiment,gpt-4.1-mini,277,1,278
2025-10-10T04:28:01Z,sentiment,gpt-4.1-mini,3400,158,3558
2025-10-10T04:28:02Z,pre_sentiment,gpt-4.1-mini,283,1,284
2025-10-10T04:28:04Z,sentiment,gpt-4.1-mini,1447,172,1619
2025-10-10T04:28:09Z,pre_sentiment,gpt-4.1-mini,290,1,291
2025-10-10T04:28:12Z,sentiment,gpt-4.1-mini,3627,223,3850
2025-10-10T04:28:12Z,pre_sentiment,gpt-4.1-mini,269,1,270
2025-10-10T04:28:13Z,pre_sentiment,gpt-4.1-mini,265,1,266
2025-10-10T04:28:16Z,sentiment,gpt-4.1-mini,1673,222,1895
2025-10-10T04:28:21Z,pre_sentiment,gpt-4.1-mini,277,1,278
2025-10-10T04:28:21Z,pre_sentiment,gpt-4.1-mini,280,1,281
2025-10-10T04:28:24Z,sentiment,gpt-4.1-mini,1817,198,2015
2025-10-10T04:28:24Z,pre_sentiment,gpt-4.1-mini,271,1,272
2025-10-10T04:28:28Z,sentiment,gpt-4.1-mini,2013,230,2243
2025-10-10T04:28:28Z,pre_sentiment,gpt-4.1-mini,276,1,277
2025-10-10T04:28:28Z,pre_sentiment,gpt-4.1-mini,281,1,282
2025-10-10T04:28:29Z,pre_sentiment,gpt-4.1-mini,289,1,290
2025-10-10T04:28:45Z,pre_sentiment,gpt-4.1-mini,286,1,287
2025-10-10T04:28:47Z,sentiment,gpt-4.1-mini,1589,154,1743
2025-10-10T04:28:48Z,pre_sentiment,gpt-4.1-mini,287,1,288
2025-10-10T04:28:51Z,sentiment,gpt-4.1-mini,1706,197,1903
2025-10-10T04:28:51Z,pre_sentiment,gpt-4.1-mini,280,1,281
2025-10-10T04:28:55Z,sentiment,gpt-4.1-mini,1501,215,1716
2025-10-10T04:28:55Z,pre_sentiment,gpt-4.1-mini,285,1,286
2025-10-10T04:28:58Z,sentiment,gpt-4.1-mini,1456,180,1636
2025-10-10T04:28:58Z,pre_sentiment,gpt-4.1-mini,287,1,288
2025-10-10T04:29:01Z,sentiment,gpt-4.1-mini,1362,194,1556
2025-10-10T04:29:02Z,pre_sentiment,gpt-4.1-mini,283,1,284
2025-10-10T04:29:04Z,sentiment,gpt-4.1-mini,1694,194,1888
2025-10-10T04:29:05Z,pre_sentiment,gpt-4.1-mini,289,1,290
2025-10-10T04:29:07Z,sentiment,gpt-4.1-mini,1566,146,1712
2025-10-10T04:29:07Z,pre_sentiment,gpt-4.1-mini,287,1,288
2025-10-10T04:29:08Z,pre_sentiment,gpt-4.1-mini,283,1,284
2025-10-10T04:29:11Z,sentiment,gpt-4.1-mini,1772,203,1975
2025-10-10T04:29:19Z,pre_sentiment,gpt-4.1-mini,281,1,282
2025-10-10T04:29:32Z,pre_sentiment,gpt-4.1-mini,292,1,293
2025-10-10T04:29:34Z,sentiment,gpt-4.1-mini,1169,117,1286
2025-10-10T04:29:38Z,pre_sentiment,gpt-4.1-mini,292,1,293
2025-10-10T04:29:40Z,sentiment,gpt-4.1-mini,1135,129,1264
2025-10-10T04:29:40Z,pre_sentiment,gpt-4.1-mini,298,1,299
2025-10-10T04:29:42Z,sentiment,gpt-4.1-mini,1398,144,1542
2025-10-10T04:29:47Z,pre_sentiment,gpt-4.1-mini,281,1,282
2025-10-10T04:30:11Z,pre_sentiment,gpt-4.1-mini,290,1,291
2025-10-10T04:30:22Z,pre_sentiment,gpt-4.1-mini,292,1,293
2025-10-10T04:30:24Z,sentiment,gpt-4.1-mini,1286,171,1457
2025-10-10T04:30:25Z,pre_sentiment,gpt-4.1-mini,286,1,287
2025-10-10T04:30:26Z,pre_sentiment,gpt-4.1-mini,287,1,288
2025-10-10T04:30:26Z,pre_sentiment,gpt-4.1-mini,285,1,286
2025-10-10T04:30:27Z,pre_sentiment,gpt-4.1-mini,284,1,285
2025-10-10T04:30:27Z,pre_sentiment,gpt-4.1-mini,272,1,273
2025-10-10T04:30:29Z,sentiment,gpt-4.1-mini,1381,152,1533
2025-10-10T04:30:37Z,pre_sentiment,gpt-4.1-mini,293,1,294
2025-10-10T04:30:44Z,sentiment,gpt-4.1-mini,1772,195,1967
2025-10-10T04:30:45Z,pre_sentiment,gpt-4.1-mini,297,1,298
2025-10-10T04:30:46Z,pre_sentiment,gpt-4.1-mini,285,1,286
2025-10-10T04:30:46Z,pre_sentiment,gpt-4.1-mini,292,1,293
2025-10-10T04:30:47Z,pre_sentiment,gpt-4.1-mini,289,1,290
2025-10-10T04:30:49Z,sentiment,gpt-4.1-mini,951,167,1118
2025-10-10T04:30:49Z,pre_sentiment,gpt-4.1-mini,283,1,284
2025-10-10T04:30:54Z,sentiment,gpt-4.1-mini,1765,191,1956
2025-10-10T04:31:12Z,pre_sentiment,gpt-4.1-mini,287,1,288
2025-10-10T04:31:15Z,sentiment,gpt-4.1-mini,2707,184,2891
2025-10-10T04:31:16Z,pre_sentiment,gpt-4.1-mini,284,1,285
2025-10-10T04:31:19Z,sentiment,gpt-4.1-mini,2841,229,3070
2025-10-10T04:31:20Z,pre_sentiment,gpt-4.1-mini,292,1,293
2025-10-10T04:31:35Z,pre_sentiment,gpt-4.1-mini,287,1,288
2025-10-10T04:31:35Z,pre_sentiment,gpt-4.1-mini,281,1,282
2025-10-10T04:31:37Z,sentiment,gpt-4.1-mini,1156,149,1305
2025-10-10T04:31:38Z,pre_sentiment,gpt-4.1-mini,279,1,280
2025-10-10T04:31:38Z,pre_sentiment,gpt-4.1-mini,288,1,289
2025-10-10T04:31:39Z,pre_sentiment,gpt-4.1-mini,292,1,293
2025-10-10T04:31:39Z,pre_sentiment,gpt-4.1-mini,292,1,293
2025-10-10T04:31:39Z,pre_sentiment,gpt-4.1-mini,294,1,295
2025-10-10T04:31:42Z,sentiment,gpt-4.1-mini,1460,162,1622
2025-10-10T04:31:42Z,pre_sentiment,gpt-4.1-mini,291,1,292
2025-10-10T04:31:45Z,sentiment,gpt-4.1-mini,1605,199,1804
2025-10-10T04:31:46Z,pre_sentiment,gpt-4.1-mini,282,1,283
2025-10-10T04:31:46Z,pre_sentiment,gpt-4.1-mini,283,1,284
2025-10-10T04:31:47Z,pre_sentiment,gpt-4.1-mini,297,1,298
2025-10-10T04:31:47Z,pre_sentiment,gpt-4.1-mini,283,1,284
2025-10-10T04:31:49Z,sentiment,gpt-4.1-mini,1310,225,1535
2025-10-10T04:31:49Z,pre_sentiment,gpt-4.1-mini,286,1,287
2025-10-10T04:31:50Z,pre_sentiment,gpt-4.1-mini,277,1,278
2025-10-10T04:31:52Z,sentiment,gpt-4.1-mini,1422,169,1591
2025-10-10T04:31:52Z,pre_sentiment,gpt-4.1-mini,278,1,279
2025-10-10T04:32:12Z,article_selection,gpt-4.1-mini,2010,18,2028
2025-10-10T04:32:14Z,article_selection,gpt-4.1-mini,3092,16,3108
2025-10-10T04:32:14Z,article_selection,gpt-4.1-mini,612,9,621
2025-10-10T04:32:15Z,article_selection,gpt-4.1-mini,523,9,532
2025-10-10T04:32:15Z,article_selection,gpt-4.1-mini,818,12,830
2025-10-10T04:32:16Z,article_selection,gpt-4.1-mini,665,12,677
2025-10-10T04:32:31Z,final_summary_en,gpt-4.1-mini,1562,1054,2616
2025-10-10T04:32:45Z,final_summary_en,gpt-4.1-mini,987,1133,2120
2025-10-10T04:33:04Z,final_summary_en,gpt-4.1-mini,1572,1186,2758
2025-10-10T04:33:21Z,final_summary_en,gpt-4.1-mini,1528,1366,2894
2025-10-10T04:33:35Z,final_summary_en,gpt-4.1-mini,1478,1058,2536
2025-10-10T04:33:53Z,final_summary_en,gpt-4.1-mini,3394,1336,4730
2025-10-10T04:34:08Z,final_summary_en,gpt-4.1-mini,1564,1176,2740
2025-10-10T04:34:24Z,final_summary_en,gpt-4.1-mini,1784,1128,2912
2025-10-10T04:34:34Z,final_summary_en,gpt-4.1-mini,1976,1242,3218
2025-10-10T04:34:56Z,final_summary_en,gpt-4.1-mini,1321,1078,2399
2025-10-10T04:35:07Z,final_summary_en,gpt-4.1-mini,1553,1296,2849
2025-10-10T04:35:18Z,final_summary_en,gpt-4.1-mini,9417,1218,10635
2025-10-10T04:35:28Z,final_summary_en,gpt-4.1-mini,1369,1115,2484
2025-10-10T04:35:39Z,final_summary_en,gpt-4.1-mini,1086,1164,2250
2025-10-10T04:35:50Z,final_summary_en,gpt-4.1-mini,1442,1178,2620
2025-10-10T04:36:00Z,final_summary_en,gpt-4.1-mini,1456,1115,2571
2025-10-10T04:36:11Z,final_summary_en,gpt-4.1-mini,2445,1182,3627
2025-10-10T04:36:19Z,final_summary_en,gpt-4.1-mini,2613,1054,3667
2025-10-10T04:36:27Z,final_summary_en,gpt-4.1-mini,1126,930,2056
2025-10-10T04:36:40Z,final_summary_en,gpt-4.1-mini,1296,1112,2408
2025-10-10T04:36:49Z,final_summary_en,gpt-4.1-mini,2420,1086,3506
2025-10-10T04:37:01Z,final_summary_en,gpt-4.1-mini,1311,1229,2540
2025-10-10T04:37:12Z,final_summary_en,gpt-4.1-mini,1339,1111,2450
2025-10-10T04:38:28Z,category_summary,gpt-4.1-mini,127,48,175
2025-10-10T04:38:31Z,category_summary,gpt-4.1-mini,135,33,168
2025-10-10T04:38:34Z,category_summary,gpt-4.1-mini,140,32,172
2025-10-10T04:38:36Z,category_summary,gpt-4.1-mini,134,34,168
2025-10-10T04:38:39Z,category_summary,gpt-4.1-mini,117,41,158
2025-10-10T04:38:41Z,category_summary,gpt-4.1-mini,115,35,150
2025-10-10T04:38:43Z,RUN_TOTAL,,215526,37433,252959
2025-10-11T04:23:34Z,pre_sentiment,gpt-4.1-mini,285,1,286
2025-10-11T04:23:38Z,sentiment,gpt-4.1-mini,1956,204,2160
2025-10-11T04:23:39Z,pre_sentiment,gpt-4.1-mini,290,1,291
2025-10-11T04:23:40Z,pre_sentiment,gpt-4.1-mini,283,1,284
2025-10-11T04:23:40Z,pre_sentiment,gpt-4.1-mini,285,1,286
2025-10-11T04:23:41Z,pre_sentiment,gpt-4.1-mini,290,1,291
2025-10-11T04:23:42Z,pre_sentiment,gpt-4.1-mini,283,1,284
2025-10-11T04:23:42Z,pre_sentiment,gpt-4.1-mini,286,1,287
2025-10-11T04:23:43Z,pre_sentiment,gpt-4.1-mini,281,1,282
2025-10-11T04:23:45Z,sentiment,gpt-4.1-mini,1106,136,1242
2025-10-11T04:23:46Z,pre_sentiment,gpt-4.1-mini,287,1,288
2025-10-11T04:23:46Z,pre_sentiment,gpt-4.1-mini,285,1,286
2025-10-11T04:23:51Z,sentiment,gpt-4.1-mini,2324,221,2545
2025-10-11T04:23:51Z,pre_sentiment,gpt-4.1-mini,287,1,288
2025-10-11T04:23:52Z,pre_sentiment,gpt-4.1-mini,283,1,284
2025-10-11T04:23:55Z,sentiment,gpt-4.1-mini,1590,182,1772
2025-10-11T04:23:55Z,pre_sentiment,gpt-4.1-mini,280,1,281
2025-10-11T04:23:57Z,pre_sentiment,gpt-4.1-mini,286,1,287
2025-10-11T04:23:57Z,pre_sentiment,gpt-4.1-mini,281,1,282
2025-10-11T04:24:03Z,pre_sentiment,gpt-4.1-mini,286,1,287
2025-10-11T04:24:04Z,pre_sentiment,gpt-4.1-mini,282,1,283
2025-10-11T04:24:06Z,sentiment,gpt-4.1-mini,1179,113,1292
2025-10-11T04:24:06Z,pre_sentiment,gpt-4.1-mini,286,1,287
2025-10-11T04:24:06Z,pre_sentiment,gpt-4.1-mini,283,1,284
2025-10-11T04:24:06Z,pre_sentiment,gpt-4.1-mini,285,1,286
2025-10-11T04:24:13Z,pre_sentiment,gpt-4.1-mini,280,1,281
2025-10-11T04:24:17Z,sentiment,gpt-4.1-mini,1470,189,1659
2025-10-11T04:24:17Z,pre_sentiment,gpt-4.1-mini,282,1,283
2025-10-11T04:24:20Z,sentiment,gpt-4.1-mini,1700,186,1886
2025-10-11T04:24:20Z,pre_sentiment,gpt-4.1-mini,280,1,281
2025-10-11T04:24:23Z,sentiment,gpt-4.1-mini,1698,194,1892
2025-10-11T04:24:29Z,pre_sentiment,gpt-4.1-mini,281,1,282
2025-10-11T04:24:33Z,sentiment,gpt-4.1-mini,2126,227,2353
2025-10-11T04:24:33Z,pre_sentiment,gpt-4.1-mini,287,1,288
2025-10-11T04:24:36Z,sentiment,gpt-4.1-mini,2207,231,2438
2025-10-11T04:24:37Z,pre_sentiment,gpt-4.1-mini,281,1,282
2025-10-11T04:24:37Z,pre_sentiment,gpt-4.1-mini,285,1,286
2025-10-11T04:24:40Z,sentiment,gpt-4.1-mini,1334,181,1515
2025-10-11T04:24:41Z,pre_sentiment,gpt-4.1-mini,280,1,281
2025-10-11T04:24:44Z,sentiment,gpt-4.1-mini,2414,213,2627
2025-10-11T04:25:03Z,pre_sentiment,gpt-4.1-mini,305,1,306
2025-10-11T04:25:03Z,pre_sentiment,gpt-4.1-mini,293,1,294
2025-10-11T04:25:05Z,sentiment,gpt-4.1-mini,910,106,1016
2025-10-11T04:25:05Z,pre_sentiment,gpt-4.1-mini,296,1,297
2025-10-11T04:25:06Z,pre_sentiment,gpt-4.1-mini,293,1,294
2025-10-11T04:25:08Z,sentiment,gpt-4.1-mini,1055,178,1233
2025-10-11T04:25:09Z,pre_sentiment,gpt-4.1-mini,297,1,298
2025-10-11T04:25:12Z,sentiment,gpt-4.1-mini,1935,243,2178
2025-10-11T04:25:13Z,pre_sentiment,gpt-4.1-mini,286,1,287
2025-10-11T04:25:15Z,sentiment,gpt-4.1-mini,1664,145,1809
2025-10-11T04:25:16Z,pre_sentiment,gpt-4.1-mini,302,1,303
2025-10-11T04:25:16Z,pre_sentiment,gpt-4.1-mini,300,1,301
2025-10-11T04:25:16Z,pre_sentiment,gpt-4.1-mini,295,1,296
2025-10-11T04:25:19Z,sentiment,gpt-4.1-mini,1386,159,1545
2025-10-11T04:25:19Z,pre_sentiment,gpt-4.1-mini,298,1,299
2025-10-11T04:25:22Z,sentiment,gpt-4.1-mini,1287,174,1461
2025-10-11T04:25:22Z,pre_sentiment,gpt-4.1-mini,305,1,306
2025-10-11T04:25:25Z,sentiment,gpt-4.1-mini,1456,162,1618
2025-10-11T04:25:25Z,pre_sentiment,gpt-4.1-mini,304,1,305
2025-10-11T04:25:29Z,sentiment,gpt-4.1-mini,1870,239,2109
2025-10-11T04:25:29Z,pre_sentiment,gpt-4.1-mini,299,1,300
2025-10-11T04:25:33Z,sentiment,gpt-4.1-mini,1571,221,1792
2025-10-11T04:25:33Z,pre_sentiment,gpt-4.1-mini,301,1,302
2025-10-11T04:25:36Z,sentiment,gpt-4.1-mini,1648,173,1821
2025-10-11T04:25:36Z,pre_sentiment,gpt-4.1-mini,298,1,299
2025-10-11T04:25:39Z,sentiment,gpt-4.1-mini,1883,177,2060
2025-10-11T04:26:03Z,pre_sentiment,gpt-4.1-mini,286,1,287
2025-10-11T04:26:05Z,sentiment,gpt-4.1-mini,907,116,1023
2025-10-11T04:26:10Z,pre_sentiment,gpt-4.1-mini,285,1,286
2025-10-11T04:26:12Z,sentiment,gpt-4.1-mini,2144,186,2330
2025-10-11T04:26:13Z,pre_sentiment,gpt-4.1-mini,288,1,289
2025-10-11T04:26:17Z,pre_sentiment,gpt-4.1-mini,278,1,279
2025-10-11T04:26:20Z,sentiment,gpt-4.1-mini,1881,162,2043
2025-10-11T04:26:21Z,pre_sentiment,gpt-4.1-mini,275,1,276
2025-10-11T04:26:21Z,pre_sentiment,gpt-4.1-mini,283,1,284
2025-10-11T04:26:21Z,pre_sentiment,gpt-4.1-mini,277,1,278
2025-10-11T04:26:34Z,pre_sentiment,gpt-4.1-mini,282,1,283
2025-10-11T04:26:37Z,sentiment,gpt-4.1-mini,1537,176,1713
2025-10-11T04:26:37Z,pre_sentiment,gpt-4.1-mini,279,1,280
2025-10-11T04:26:41Z,sentiment,gpt-4.1-mini,1596,190,1786
2025-10-11T04:26:41Z,pre_sentiment,gpt-4.1-mini,280,1,281
2025-10-11T04:26:45Z,sentiment,gpt-4.1-mini,1875,151,2026
2025-10-11T04:26:57Z,pre_sentiment,gpt-4.1-mini,295,1,296
2025-10-11T04:26:59Z,sentiment,gpt-4.1-mini,1152,119,1271
2025-10-11T04:26:59Z,pre_sentiment,gpt-4.1-mini,290,1,291
2025-10-11T04:27:01Z,sentiment,gpt-4.1-mini,1118,122,1240
2025-10-11T04:27:10Z,pre_sentiment,gpt-4.1-mini,290,1,291
2025-10-11T04:27:21Z,pre_sentiment,gpt-4.1-mini,305,1,306
2025-10-11T04:27:25Z,sentiment,gpt-4.1-mini,4403,194,4597
2025-10-11T04:27:25Z,pre_sentiment,gpt-4.1-mini,284,1,285
2025-10-11T04:27:29Z,sentiment,gpt-4.1-mini,1613,203,1816
2025-10-11T04:27:30Z,pre_sentiment,gpt-4.1-mini,294,1,295
2025-10-11T04:27:32Z,sentiment,gpt-4.1-mini,1637,116,1753
2025-10-11T04:27:41Z,pre_sentiment,gpt-4.1-mini,283,1,284
2025-10-11T04:27:44Z,sentiment,gpt-4.1-mini,1248,135,1383
2025-10-11T04:27:51Z,pre_sentiment,gpt-4.1-mini,289,1,290
2025-10-11T04:27:51Z,pre_sentiment,gpt-4.1-mini,287,1,288
2025-10-11T04:27:52Z,pre_sentiment,gpt-4.1-mini,286,1,287
2025-10-11T04:27:52Z,pre_sentiment,gpt-4.1-mini,289,1,290
2025-10-11T04:27:54Z,sentiment,gpt-4.1-mini,1464,182,1646
2025-10-11T04:27:55Z,pre_sentiment,gpt-4.1-mini,286,1,287
2025-10-11T04:28:11Z,pre_sentiment,gpt-4.1-mini,295,1,296
2025-10-11T04:28:25Z,pre_sentiment,gpt-4.1-mini,292,1,293
2025-10-11T04:28:27Z,sentiment,gpt-4.1-mini,1229,177,1406
2025-10-11T04:28:28Z,pre_sentiment,gpt-4.1-mini,289,1,290
2025-10-11T04:28:28Z,pre_sentiment,gpt-4.1-mini,294,1,295
2025-10-11T04:28:32Z,sentiment,gpt-4.1-mini,1206,196,1402
2025-10-11T04:28:32Z,pre_sentiment,gpt-4.1-mini,293,1,294
2025-10-11T04:28:32Z,pre_sentiment,gpt-4.1-mini,280,1,281
2025-10-11T04:28:35Z,sentiment,gpt-4.1-mini,1258,174,1432
2025-10-11T04:28:36Z,pre_sentiment,gpt-4.1-mini,285,1,286
2025-10-11T04:28:39Z,sentiment,gpt-4.1-mini,1318,187,1505
2025-10-11T04:28:39Z,pre_sentiment,gpt-4.1-mini,280,1,281
2025-10-11T04:28:40Z,pre_sentiment,gpt-4.1-mini,285,1,286
2025-10-11T04:28:43Z,sentiment,gpt-4.1-mini,1618,221,1839
2025-10-11T04:28:43Z,pre_sentiment,gpt-4.1-mini,278,1,279
2025-10-11T04:28:46Z,sentiment,gpt-4.1-mini,1113,172,1285
2025-10-11T04:28:46Z,pre_sentiment,gpt-4.1-mini,278,1,279
2025-10-11T04:28:49Z,sentiment,gpt-4.1-mini,979,146,1125
2025-10-11T04:28:49Z,pre_sentiment,gpt-4.1-mini,286,1,287
2025-10-11T04:29:10Z,article_selection,gpt-4.1-mini,1337,9,1346
2025-10-11T04:29:11Z,article_selection,gpt-4.1-mini,1053,12,1065
2025-10-11T04:29:11Z,article_selection,gpt-4.1-mini,1316,16,1332
2025-10-11T04:29:12Z,article_selection,gpt-4.1-mini,392,10,402
2025-10-11T04:29:24Z,final_summary_en,gpt-4.1-mini,1892,830,2722
2025-10-11T04:29:42Z,final_summary_en,gpt-4.1-mini,2169,1123,3292
2025-10-11T04:30:01Z,final_summary_en,gpt-4.1-mini,1430,1240,2670
2025-10-11T04:30:19Z,final_summary_en,gpt-4.1-mini,1349,1110,2459
2025-10-11T04:30:36Z,final_summary_en,gpt-4.1-mini,1211,1074,2285
2025-10-11T04:30:52Z,final_summary_en,gpt-4.1-mini,4146,1091,5237
2025-10-11T04:31:09Z,final_summary_en,gpt-4.1-mini,1976,1166,3142
2025-10-11T04:31:29Z,final_summary_en,gpt-4.1-mini,960,1145,2105
2025-10-11T04:31:45Z,final_summary_en,gpt-4.1-mini,2081,1180,3261
2025-10-11T04:31:59Z,final_summary_en,gpt-4.1-mini,1339,947,2286
2025-10-11T04:32:24Z,final_summary_en,gpt-4.1-mini,1901,1387,3288
2025-10-11T04:32:36Z,final_summary_en,gpt-4.1-mini,706,857,1563
2025-10-11T04:32:52Z,final_summary_en,gpt-4.1-mini,1279,1043,2322
2025-10-11T04:33:07Z,final_summary_en,gpt-4.1-mini,809,986,1795
2025-10-11T04:33:22Z,final_summary_en,gpt-4.1-mini,1184,1069,2253
2025-10-11T04:33:39Z,final_summary_en,gpt-4.1-mini,961,1115,2076
2025-10-11T04:33:53Z,final_summary_en,gpt-4.1-mini,1060,1037,2097
2025-10-11T04:34:50Z,category_summary,gpt-4.1-mini,122,31,153
2025-10-11T04:34:52Z,category_summary,gpt-4.1-mini,155,43,198
2025-10-11T04:34:54Z,category_summary,gpt-4.1-mini,82,21,103
2025-10-11T04:34:57Z,category_summary,gpt-4.1-mini,125,41,166
2025-10-11T04:35:00Z,category_summary,gpt-4.1-mini,87,22,109
2025-10-11T04:35:02Z,category_summary,gpt-4.1-mini,119,34,153
2025-10-11T04:35:04Z,RUN_TOTAL,,122454,26295,148749
2025-10-12T04:24:17Z,pre_sentiment,gpt-4.1-mini,285,1,286
2025-10-12T04:24:18Z,pre_sentiment,gpt-4.1-mini,277,1,278
2025-10-12T04:24:18Z,pre_sentiment,gpt-4.1-mini,279,1,280
2025-10-12T04:24:19Z,pre_sentiment,gpt-4.1-mini,284,1,285
2025-10-12T04:24:20Z,pre_sentiment,gpt-4.1-mini,290,1,291
2025-10-12T04:24:21Z,pre_sentiment,gpt-4.1-mini,285,1,286
2025-10-12T04:24:21Z,pre_sentiment,gpt-4.1-mini,293,1,294
2025-10-12T04:24:22Z,pre_sentiment,gpt-4.1-mini,280,1,281
2025-10-12T04:24:22Z,pre_sentiment,gpt-4.1-mini,288,1,289
2025-10-12T04:24:22Z,pre_sentiment,gpt-4.1-mini,286,1,287
2025-10-12T04:24:23Z,pre_sentiment,gpt-4.1-mini,278,1,279
2025-10-12T04:24:23Z,pre_sentiment,gpt-4.1-mini,285,1,286
2025-10-12T04:24:23Z,pre_sentiment,gpt-4.1-mini,293,1,294
2025-10-12T04:24:24Z,pre_sentiment,gpt-4.1-mini,289,1,290
2025-10-12T04:24:24Z,pre_sentiment,gpt-4.1-mini,286,1,287
2025-10-12T04:24:29Z,pre_sentiment,gpt-4.1-mini,286,1,287
2025-10-12T04:24:44Z,pre_sentiment,gpt-4.1-mini,285,1,286
2025-10-12T04:24:46Z,sentiment,gpt-4.1-mini,1315,147,1462
2025-10-12T04:24:46Z,pre_sentiment,gpt-4.1-mini,285,1,286
2025-10-12T04:24:51Z,sentiment,gpt-4.1-mini,2032,216,2248
2025-10-12T04:24:51Z,pre_sentiment,gpt-4.1-mini,285,1,286
2025-10-12T04:24:55Z,sentiment,gpt-4.1-mini,1568,210,1778
2025-10-12T04:24:55Z,pre_sentiment,gpt-4.1-mini,284,1,285
2025-10-12T04:24:59Z,sentiment,gpt-4.1-mini,1364,207,1571
2025-10-12T04:24:59Z,pre_sentiment,gpt-4.1-mini,286,1,287
2025-10-12T04:25:02Z,sentiment,gpt-4.1-mini,1550,230,1780
2025-10-12T04:25:02Z,pre_sentiment,gpt-4.1-mini,283,1,284
2025-10-12T04:25:05Z,sentiment,gpt-4.1-mini,2033,203,2236
2025-10-12T04:25:06Z,pre_sentiment,gpt-4.1-mini,279,1,280
2025-10-12T04:25:06Z,pre_sentiment,gpt-4.1-mini,281,1,282
2025-10-12T04:25:09Z,sentiment,gpt-4.1-mini,1646,199,1845
2025-10-12T04:25:09Z,pre_sentiment,gpt-4.1-mini,287,1,288
2025-10-12T04:25:12Z,sentiment,gpt-4.1-mini,1475,209,1684
2025-10-12T04:25:27Z,pre_sentiment,gpt-4.1-mini,305,1,306
2025-10-12T04:25:27Z,pre_sentiment,gpt-4.1-mini,293,1,294
2025-10-12T04:25:29Z,sentiment,gpt-4.1-mini,910,112,1022
2025-10-12T04:25:29Z,pre_sentiment,gpt-4.1-mini,296,1,297
2025-10-12T04:25:30Z,pre_sentiment,gpt-4.1-mini,297,1,298
2025-10-12T04:25:34Z,sentiment,gpt-4.1-mini,1935,184,2119
2025-10-12T04:25:34Z,pre_sentiment,gpt-4.1-mini,286,1,287
2025-10-12T04:25:36Z,sentiment,gpt-4.1-mini,1664,155,1819
2025-10-12T04:25:37Z,pre_sentiment,gpt-4.1-mini,302,1,303
2025-10-12T04:25:37Z,pre_sentiment,gpt-4.1-mini,300,1,301
2025-10-12T04:25:37Z,pre_sentiment,gpt-4.1-mini,295,1,296
2025-10-12T04:25:40Z,sentiment,gpt-4.1-mini,1386,133,1519
2025-10-12T04:25:40Z,pre_sentiment,gpt-4.1-mini,298,1,299
2025-10-12T04:25:43Z,sentiment,gpt-4.1-mini,1287,163,1450
2025-10-12T04:25:43Z,pre_sentiment,gpt-4.1-mini,305,1,306
2025-10-12T04:25:45Z,sentiment,gpt-4.1-mini,1456,155,1611
2025-10-12T04:25:45Z,pre_sentiment,gpt-4.1-mini,304,1,305
2025-10-12T04:25:48Z,sentiment,gpt-4.1-mini,1870,206,2076
2025-10-12T04:25:48Z,pre_sentiment,gpt-4.1-mini,301,1,302
2025-10-12T04:25:52Z,sentiment,gpt-4.1-mini,1648,182,1830
2025-10-12T04:25:53Z,pre_sentiment,gpt-4.1-mini,298,1,299
2025-10-12T04:25:55Z,sentiment,gpt-4.1-mini,1883,177,2060
2025-10-12T04:26:20Z,pre_sentiment,gpt-4.1-mini,264,1,265
2025-10-12T04:26:38Z,pre_sentiment,gpt-4.1-mini,288,1,289
2025-10-12T04:27:11Z,pre_sentiment,gpt-4.1-mini,278,1,279
2025-10-12T04:27:14Z,sentiment,gpt-4.1-mini,1364,195,1559
2025-10-12T04:27:27Z,pre_sentiment,gpt-4.1-mini,286,1,287
2025-10-12T04:27:27Z,pre_sentiment,gpt-4.1-mini,284,1,285
2025-10-12T04:27:30Z,sentiment,gpt-4.1-mini,2090,209,2299
2025-10-12T04:28:02Z,article_selection,gpt-4.1-mini,1122,9,1131
2025-10-12T04:28:02Z,article_selection,gpt-4.1-mini,583,9,592
2025-10-12T04:28:03Z,article_selection,gpt-4.1-mini,440,10,450
2025-10-12T04:28:03Z,article_selection,gpt-4.1-mini,452,6,458
2025-10-12T04:28:18Z,final_summary_en,gpt-4.1-mini,1780,1102,2882
2025-10-12T04:28:30Z,final_summary_en,gpt-4.1-mini,1123,857,1980
2025-10-12T04:28:46Z,final_summary_en,gpt-4.1-mini,1783,1272,3055
2025-10-12T04:29:03Z,final_summary_en,gpt-4.1-mini,1327,1162,2489
2025-10-12T04:29:17Z,final_summary_en,gpt-4.1-mini,1227,1026,2253
2025-10-12T04:29:35Z,final_summary_en,gpt-4.1-mini,1117,1027,2144
2025-10-12T04:29:53Z,final_summary_en,gpt-4.1-mini,1404,977,2381
2025-10-12T04:30:11Z,final_summary_en,gpt-4.1-mini,1844,1309,3153
2025-10-12T04:30:27Z,final_summary_en,gpt-4.1-mini,1040,1164,2204
2025-10-12T04:30:44Z,final_summary_en,gpt-4.1-mini,1320,1219,2539
2025-10-12T04:31:01Z,final_summary_en,gpt-4.1-mini,1176,1155,2331
2025-10-12T04:31:16Z,final_summary_en,gpt-4.1-mini,1636,1127,2763
2025-10-12T04:31:34Z,final_summary_en,gpt-4.1-mini,1690,1285,2975
2025-10-12T04:32:18Z,category_summary,gpt-4.1-mini,129,33,162
2025-10-12T04:32:21Z,category_summary,gpt-4.1-mini,104,23,127
2025-10-12T04:32:23Z,category_summary,gpt-4.1-mini,113,22,135
2025-10-12T04:32:24Z,category_summary,gpt-4.1-mini,110,28,138
2025-10-12T04:32:28Z,category_summary,gpt-4.1-mini,89,28,117
2025-10-12T04:32:29Z,RUN_TOTAL,,64484,18385,82869
2025-10-13T04:26:10Z,pre_sentiment,gpt-4.1-mini,284,1,285
2025-10-13T04:26:11Z,pre_sentiment,gpt-4.1-mini,284,1,285
2025-10-13T04:26:11Z,pre_sentiment,gpt-4.1-mini,280,1,281
2025-10-13T04:26:13Z,pre_sentiment,gpt-4.1-mini,280,1,281
2025-10-13T04:26:15Z,sentiment,gpt-4.1-mini,1294,128,1422
2025-10-13T04:26:16Z,pre_sentiment,gpt-4.1-mini,284,1,285
2025-10-13T04:26:17Z,pre_sentiment,gpt-4.1-mini,281,1,282
2025-10-13T04:26:17Z,pre_sentiment,gpt-4.1-mini,287,1,288
2025-10-13T04:26:17Z,pre_sentiment,gpt-4.1-mini,285,1,286
2025-10-13T04:26:19Z,pre_sentiment,gpt-4.1-mini,291,1,292
2025-10-13T04:26:19Z,pre_sentiment,gpt-4.1-mini,288,1,289
2025-10-13T04:26:19Z,pre_sentiment,gpt-4.1-mini,290,1,291
2025-10-13T04:26:20Z,pre_sentiment,gpt-4.1-mini,284,1,285
2025-10-13T04:26:20Z,pre_sentiment,gpt-4.1-mini,282,1,283
2025-10-13T04:26:42Z,pre_sentiment,gpt-4.1-mini,281,1,282
2025-10-13T04:26:42Z,pre_sentiment,gpt-4.1-mini,280,1,281
2025-10-13T04:26:46Z,sentiment,gpt-4.1-mini,2234,205,2439
2025-10-13T04:26:46Z,pre_sentiment,gpt-4.1-mini,286,1,287
2025-10-13T04:26:49Z,sentiment,gpt-4.1-mini,2129,194,2323
2025-10-13T04:26:50Z,pre_sentiment,gpt-4.1-mini,283,1,284
2025-10-13T04:26:52Z,sentiment,gpt-4.1-mini,1306,169,1475
2025-10-13T04:26:53Z,pre_sentiment,gpt-4.1-mini,282,1,283
2025-10-13T04:26:56Z,sentiment,gpt-4.1-mini,2165,171,2336
2025-10-13T04:26:56Z,pre_sentiment,gpt-4.1-mini,281,1,282
2025-10-13T04:26:59Z,sentiment,gpt-4.1-mini,1446,186,1632
2025-10-13T04:26:59Z,pre_sentiment,gpt-4.1-mini,277,1,278
2025-10-13T04:27:02Z,sentiment,gpt-4.1-mini,1595,202,1797
2025-10-13T04:27:03Z,pre_sentiment,gpt-4.1-mini,284,1,285
2025-10-13T04:27:07Z,sentiment,gpt-4.1-mini,1791,208,1999
2025-10-13T04:27:07Z,pre_sentiment,gpt-4.1-mini,277,1,278
2025-10-13T04:27:11Z,sentiment,gpt-4.1-mini,2088,241,2329
2025-10-13T04:27:11Z,pre_sentiment,gpt-4.1-mini,283,1,284
2025-10-13T04:27:15Z,sentiment,gpt-4.1-mini,2322,214,2536
2025-10-13T04:27:15Z,pre_sentiment,gpt-4.1-mini,285,1,286
2025-10-13T04:27:18Z,sentiment,gpt-4.1-mini,1552,173,1725
2025-10-13T04:27:18Z,pre_sentiment,gpt-4.1-mini,281,1,282
2025-10-13T04:27:19Z,pre_sentiment,gpt-4.1-mini,278,1,279
2025-10-13T04:27:21Z,sentiment,gpt-4.1-mini,1300,169,1469
2025-10-13T04:27:22Z,pre_sentiment,gpt-4.1-mini,281,1,282
2025-10-13T04:27:26Z,sentiment,gpt-4.1-mini,1663,191,1854
2025-10-13T04:27:43Z,pre_sentiment,gpt-4.1-mini,300,1,301
2025-10-13T04:27:43Z,pre_sentiment,gpt-4.1-mini,305,1,306
2025-10-13T04:27:44Z,pre_sentiment,gpt-4.1-mini,293,1,294
2025-10-13T04:27:45Z,sentiment,gpt-4.1-mini,910,98,1008
2025-10-13T04:27:46Z,pre_sentiment,gpt-4.1-mini,296,1,297
2025-10-13T04:27:46Z,pre_sentiment,gpt-4.1-mini,286,1,287
2025-10-13T04:27:49Z,sentiment,gpt-4.1-mini,1664,132,1796
2025-10-13T04:27:49Z,pre_sentiment,gpt-4.1-mini,302,1,303
2025-10-13T04:27:49Z,pre_sentiment,gpt-4.1-mini,300,1,301
2025-10-13T04:27:50Z,pre_sentiment,gpt-4.1-mini,295,1,296
2025-10-13T04:27:52Z,sentiment,gpt-4.1-mini,1386,142,1528
2025-10-13T04:27:52Z,pre_sentiment,gpt-4.1-mini,298,1,299
2025-10-13T04:27:54Z,sentiment,gpt-4.1-mini,1287,170,1457
2025-10-13T04:27:55Z,pre_sentiment,gpt-4.1-mini,305,1,306
2025-10-13T04:27:58Z,sentiment,gpt-4.1-mini,1456,172,1628
2025-10-13T04:27:58Z,pre_sentiment,gpt-4.1-mini,301,1,302
2025-10-13T04:28:01Z,sentiment,gpt-4.1-mini,1648,190,1838
2025-10-13T04:28:29Z,pre_sentiment,gpt-4.1-mini,287,1,288
2025-10-13T04:28:29Z,pre_sentiment,gpt-4.1-mini,264,1,265
2025-10-13T04:28:32Z,sentiment,gpt-4.1-mini,1675,203,1878
2025-10-13T04:28:37Z,pre_sentiment,gpt-4.1-mini,277,1,278
2025-10-13T04:28:41Z,pre_sentiment,gpt-4.1-mini,278,1,279
2025-10-13T04:29:38Z,pre_sentiment,gpt-4.1-mini,289,1,290
2025-10-13T04:29:40Z,sentiment,gpt-4.1-mini,1621,165,1786
2025-10-13T04:29:40Z,pre_sentiment,gpt-4.1-mini,290,1,291
2025-10-13T04:29:42Z,sentiment,gpt-4.1-mini,1656,106,1762
2025-10-13T04:30:01Z,pre_sentiment,gpt-4.1-mini,284,1,285
2025-10-13T04:30:15Z,pre_sentiment,gpt-4.1-mini,282,1,283
2025-10-13T04:30:15Z,pre_sentiment,gpt-4.1-mini,284,1,285
2025-10-13T04:30:20Z,sentiment,gpt-4.1-mini,2404,174,2578
2025-10-13T04:30:21Z,pre_sentiment,gpt-4.1-mini,279,1,280
2025-10-13T04:30:24Z,sentiment,gpt-4.1-mini,2794,215,3009
2025-10-13T04:30:45Z,article_selection,gpt-4.1-mini,1092,12,1104
2025-10-13T04:30:45Z,article_selection,gpt-4.1-mini,470,6,476
2025-10-13T04:30:46Z,article_selection,gpt-4.1-mini,584,13,597
2025-10-13T04:30:46Z,article_selection,gpt-4.1-mini,649,16,665
2025-10-13T04:30:47Z,article_selection,gpt-4.1-mini,472,7,479
2025-10-13T04:31:09Z,final_summary_en,gpt-4.1-mini,1986,1301,3287
2025-10-13T04:31:33Z,final_summary_en,gpt-4.1-mini,1350,1147,2497
2025-10-13T04:31:53Z,final_summary_en,gpt-4.1-mini,1865,1440,3305
2025-10-13T04:32:08Z,final_summary_en,gpt-4.1-mini,1029,1067,2096
2025-10-13T04:32:28Z,final_summary_en,gpt-4.1-mini,1875,1296,3171
2025-10-13T04:32:50Z,final_summary_en,gpt-4.1-mini,1556,1312,2868
2025-10-13T04:33:11Z,final_summary_en,gpt-4.1-mini,2091,1216,3307
2025-10-13T04:33:34Z,final_summary_en,gpt-4.1-mini,1198,1079,2277
2025-10-13T04:33:51Z,final_summary_en,gpt-4.1-mini,2139,1126,3265
2025-10-13T04:34:10Z,final_summary_en,gpt-4.1-mini,1297,1170,2467
2025-10-13T04:34:31Z,final_summary_en,gpt-4.1-mini,1037,998,2035
2025-10-13T04:34:48Z,final_summary_en,gpt-4.1-mini,1435,1010,2445
2025-10-13T04:35:11Z,final_summary_en,gpt-4.1-mini,2558,1401,3959
2025-10-13T04:35:29Z,final_summary_en,gpt-4.1-mini,1415,1018,2433
2025-10-13T04:36:25Z,category_summary,gpt-4.1-mini,130,34,164
2025-10-13T04:36:27Z,category_summary,gpt-4.1-mini,121,27,148
2025-10-13T04:36:28Z,category_summary,gpt-4.1-mini,86,23,109
2025-10-13T04:36:30Z,category_summary,gpt-4.1-mini,100,30,130
2025-10-13T04:36:33Z,category_summary,gpt-4.1-mini,121,41,162
2025-10-13T04:36:34Z,RUN_TOTAL,,81776,21056,102832
